State,FIPS,Name,ObamaMargin,TotalVotes,Obama,Romney
WY,56045,Weston,-2399,3323,422,2821
WY,56043,Washakie,-2219,3911,794,3013
WY,56041,Uinta,-4985,8453,1628,6613
WY,56039,Teton,1353,11356,6211,4858
WY,56037,Sweetwater,-6654,16750,4773,11427
WY,56035,Sublette,-2705,4337,767,3472
WY,56033,Sheridan,-6649,14225,3618,10267
WY,56031,Platte,-1913,4500,1223,3136
WY,56029,Park,-8307,14492,2927,11234
WY,56027,Niobrara,-822,1268,200,1022
WY,56025,Natrona,-13169,32057,8960,22129
WY,56023,Lincoln,-5857,8573,1287,7144
WY,56021,Laramie,-9440,38057,13807,23247
WY,56019,Johnson,-2613,4217,749,3362
WY,56017,Hot Springs,-1371,2495,523,1894
WY,56015,Goshen,-2720,5758,1458,4178
WY,56013,Fremont,-5739,16817,5333,11072
WY,56011,Crook,-2683,3657,426,3109
WY,56009,Converse,-3954,6287,1089,5043
WY,56007,Carbon,-2043,6461,2109,4152
WY,56005,Campbell,-12789,17477,2163,14952
WY,56003,Big Horn,-3401,5262,868,4269
WY,56001,Albany,-406,16052,7445,7851
WI,55141,Wood,-1139,38762,18546,19685
WI,55139,Winnebago,3337,88814,45410,42073
WI,55137,Waushara,-1228,12017,5330,6558
WI,55135,Waupaca,-2424,25801,11565,13989
WI,55133,Waukesha,-83950,241084,77617,161567
WI,55131,Washington,-31573,78558,23136,54709
WI,55129,Washburn,-257,9242,4435,4692
WI,55127,Walworth,-6450,52115,22512,28962
WI,55125,Vilas,-1804,13782,5931,7735
WI,55123,Vernon,2096,14215,8031,5935
WI,55121,Trempealeau,1898,13456,7601,5703
WI,55119,Taylor,-1836,9486,3761,5597
WI,55117,Sheboygan,-5926,63272,28356,34282
WI,55115,Shawano,-2027,20222,8990,11017
WI,55113,Sawyer,46,9003,4482,4436
WI,55111,Sauk,5889,31832,18718,12829
WI,55109,St. Croix,-5601,46009,19874,25475
WI,55107,Rusk,-282,7171,3391,3673
WI,55105,Rock,18666,80462,49158,30492
WI,55103,Richland,1389,8636,4964,3575
WI,55101,Racine,3714,102937,52887,49173
WI,55099,Price,3,7870,3882,3879
WI,55097,Portage,5453,39186,22052,16599
WI,55095,Polk,-2021,22494,10054,12075
WI,55093,Pierce,-170,20920,10213,10383
WI,55091,Pepin,82,3696,1875,1793
WI,55089,Ozaukee,-16916,55565,19075,35991
WI,55087,Outagamie,-1729,94237,45565,47294
WI,55085,Oneida,-466,21577,10439,10905
WI,55083,Oconto,-1881,19727,8810,10691
WI,55081,Monroe,-132,19389,9505,9637
WI,55079,Milwaukee,169660,490944,328090,158430
WI,55078,Menominee,1012,1376,1191,179
WI,55077,Marquette,354,7944,4112,3758
WI,55075,Marinette,-741,20712,9868,10609
WI,55073,Marathon,-4238,69637,32330,36568
WI,55071,Manitowoc,-1199,42488,20382,21581
WI,55069,Lincoln,99,15152,7543,7444
WI,55067,Langlade,-1241,10482,4569,5810
WI,55065,Lafayette,1221,7928,4534,3313
WI,55063,La Crosse,10921,63212,36632,25711
WI,55061,Kewaunee,-595,11018,5151,5746
WI,55059,Kenosha,9896,80661,44838,34942
WI,55057,Juneau,837,11781,6237,5400
WI,55055,Jefferson,-3353,44136,20136,23489
WI,55053,Jackson,1397,9290,5297,3900
WI,55051,Iron,-5,3620,1783,1788
WI,55049,Iowa,3797,12515,8099,4302
WI,55047,Green Lake,-1989,9657,3790,5779
WI,55045,Green,3348,19302,11196,7848
WI,55043,Grant,3319,24160,13574,10255
WI,55041,Forest,249,4643,2421,2172
WI,55039,Fond du Lac,-7973,53272,22356,30329
WI,55037,Florence,-691,2615,952,1643
WI,55035,Eau Claire,7400,54595,30618,23218
WI,55033,Dunn,1093,21899,11303,10210
WI,55031,Douglas,7157,22862,14855,7698
WI,55029,Door,1229,17607,9338,8109
WI,55027,Dodge,-6445,44379,18745,25190
WI,55025,Dane,131930,302845,215389,83459
WI,55023,Crawford,1558,7791,4622,3064
WI,55021,Columbia,4144,30460,17158,13014
WI,55019,Clark,-1221,13740,6173,7394
WI,55017,Chippewa,-160,30914,15211,15371
WI,55015,Calumet,-3042,26336,11477,14519
WI,55013,Burnett,-560,8634,3981,4541
WI,55011,Buffalo,217,7008,3569,3352
WI,55009,Brown,-2305,128514,62433,64738
WI,55007,Bayfield,2428,9759,6025,3597
WI,55005,Barron,-530,22583,10883,11413
WI,55003,Ashland,2571,8342,5387,2816
WI,55001,Adams,894,10263,5537,4643
WV,54109,Wyoming,-4176,7496,1575,5751
WV,54107,Wood,-10913,33600,11067,21980
WV,54105,Wirt,-749,2163,673,1422
WV,54103,Wetzel,-1255,5808,2194,3449
WV,54101,Webster,-769,2744,939,1708
WV,54099,Wayne,-3758,13923,4915,8673
WV,54097,Upshur,-3735,8195,2143,5878
WV,54095,Tyler,-1411,3245,880,2291
WV,54093,Tucker,-1284,3118,876,2160
WV,54091,Taylor,-1894,5887,1933,3827
WV,54089,Summers,-1356,4712,1612,2968
WV,54087,Roane,-1045,5027,1928,2973
WV,54085,Ritchie,-2127,3749,762,2889
WV,54083,Randolph,-2825,9727,3325,6150
WV,54081,Raleigh,-12724,28499,7651,20375
WV,54079,Putnam,-8728,23501,7198,15926
WV,54077,Preston,-4925,11089,2916,7841
WV,54075,Pocahontas,-869,3553,1298,2167
WV,54073,Pleasants,-863,2807,942,1805
WV,54071,Pendleton,-1020,3224,1067,2087
WV,54069,Ohio,-3954,17541,6623,10577
WV,54067,Nicholas,-3188,8676,2635,5823
WV,54065,Morgan,-2147,7037,2361,4508
WV,54063,Monroe,-2130,5152,1441,3571
WV,54061,Monongalia,-3008,31140,13664,16672
WV,54059,Mingo,-3742,8794,2421,6163
WV,54057,Mineral,-4851,10784,2836,7687
WV,54055,Mercer,-9990,21216,5416,15406
WV,54053,Mason,-1968,9713,3738,5706
WV,54051,Marshall,-2813,9849,3395,6208
WV,54049,Marion,-3076,21414,8905,11981
WV,54047,McDowell,-1845,6136,2086,3931
WV,54045,Logan,-4725,11901,3461,8186
WV,54043,Lincoln,-2132,6747,2204,4336
WV,54041,Lewis,-2630,6243,1719,4349
WV,54039,Kanawha,-8847,74451,32190,41037
WV,54037,Jefferson,-875,21776,10215,11090
WV,54035,Jackson,-3536,11465,3824,7360
WV,54033,Harrison,-6095,25948,9660,15755
WV,54031,Hardy,-2046,5149,1477,3523
WV,54029,Hancock,-2588,11991,4571,7159
WV,54027,Hampshire,-3220,7972,2294,5514
WV,54025,Greenbrier,-3192,12872,4681,7873
WV,54023,Grant,-3062,4572,713,3775
WV,54021,Gilmer,-750,2482,830,1580
WV,54019,Fayette,-2936,13971,5368,8304
WV,54017,Doddridge,-1537,2743,571,2108
WV,54015,Clay,-1035,2989,922,1957
WV,54013,Calhoun,-487,2157,801,1288
WV,54011,Cabell,-4399,31744,13380,17779
WV,54009,Brooke,-1030,9224,3984,5014
WV,54007,Braxton,-707,4756,1985,2692
WV,54005,Boone,-2637,8434,2777,5414
WV,54003,Berkeley,-7834,36804,14122,21956
WV,54001,Barbour,-2043,5733,1761,3804
WA,53077,Yakima,-9436,62449,25945,35381
WA,53075,Whitman,-550,14851,6910,7460
WA,53073,Whatcom,10979,91158,49743,38764
WA,53071,Walla Walla,-3385,15155,5713,9098
WA,53069,Wahkiakum,-24,2285,1091,1115
WA,53067,Thurston,21176,111652,64879,43703
WA,53065,Stevens,-4780,17281,6014,10794
WA,53063,Spokane,-12820,202088,91977,104797
WA,53061,Snohomish,48285,298759,169927,121642
WA,53059,Skamania,-70,5326,2554,2624
WA,53057,Skagit,2457,42273,21875,19418
WA,53055,San Juan,3882,10345,6943,3061
WA,53053,Pierce,36452,332134,180478,144026
WA,53051,Pend Oreille,-1441,6649,2501,3942
WA,53049,Pacific,1200,10477,5684,4484
WA,53047,Okanogan,-1892,12781,5259,7151
WA,53045,Mason,1931,27897,14568,12637
WA,53043,Lincoln,-2375,5804,1649,4024
WA,53041,Lewis,-6182,26348,9772,15954
WA,53039,Klickitat,-765,9861,4373,5138
WA,53037,Kittitas,-1910,15152,6462,8372
WA,53035,Kitsap,12233,109919,59701,47468
WA,53033,King,347706,871654,599796,252090
WA,53031,Jefferson,5872,18717,11985,6113
WA,53029,Island,1829,41319,21080,19251
WA,53027,Grays Harbor,3949,28224,15692,11743
WA,53025,Grant,-8824,27041,8746,17570
WA,53023,Garfield,-577,1275,335,912
WA,53021,Franklin,-4781,18940,6876,11657
WA,53019,Ferry,-690,3391,1276,1966
WA,53017,Douglas,-4240,14678,5047,9287
WA,53015,Cowlitz,1790,40976,20897,19107
WA,53013,Columbia,-911,2222,634,1545
WA,53011,Clark,193,181567,88822,88629
WA,53009,Clallam,144,35242,17231,17087
WA,53007,Chelan,-5222,30952,12519,17741
WA,53005,Benton,-21259,78874,27846,49105
WA,53003,Asotin,-1654,9883,3993,5647
WA,53001,Adams,-1595,4707,1516,3111
VA,51840,Winchester,146,10254,5089,4943
VA,51830,Williamsburg,2223,7722,4901,2678
VA,51820,Waynesboro,-953,8772,3836,4789
VA,51810,Virginia Beach,-4944,195823,94163,99107
VA,51800,Suffolk,6416,42381,24194,17778
VA,51790,Staunton,453,11154,5710,5257
VA,51775,Salem,-2533,12270,4756,7289
VA,51770,Roanoke City,8063,37479,22179,14116
VA,51760,Richmond City,51305,92175,71037,19732
VA,51750,Radford,212,5382,2732,2520
VA,51740,Portsmouth,16587,41860,28994,12407
VA,51735,Poquoson,-3633,7098,1679,5312
VA,51730,Petersburg,12851,15977,14377,1526
VA,51720,Norton,-329,1486,566,895
VA,51710,Norfolk,34288,77925,55654,21366
VA,51700,Newport News,23766,79169,50990,27224
VA,51690,Martinsville,1543,6277,3855,2312
VA,51685,Manassas Park,1177,4627,2873,1696
VA,51683,Manassas,2015,15154,8478,6463
VA,51680,Lynchburg,-3847,36242,15905,19752
VA,51678,Lexington,338,2677,1484,1146
VA,51670,Hopewell,1441,9011,5178,3737
VA,51660,Harrisonburg,2086,15541,8650,6564
VA,51650,Hampton,32540,71713,51733,19193
VA,51640,Galax,-432,2273,900,1332
VA,51630,Fredericksburg,3060,11396,7114,4054
VA,51620,Franklin City,1334,4351,2830,1496
VA,51610,Falls Church,2865,7244,5006,2141
VA,51600,Fairfax City,1874,11577,6636,4762
VA,51595,Emporia,907,2691,1793,886
VA,51590,Danville,4459,20169,12215,7756
VA,51580,Covington,344,2329,1319,975
VA,51570,Colonial Heights,-3396,8593,2541,5937
VA,51550,Chesapeake,1154,110105,54999,53845
VA,51540,Charlottesville,11466,21455,16267,4801
VA,51530,Buena Vista,-645,2526,919,1564
VA,51520,Bristol,-2289,7356,2487,4776
VA,51515,Bedford City,-302,2798,1225,1527
VA,51510,Alexandria,32229,73470,52434,20205
VA,51199,York,-7017,33848,13165,20182
VA,51197,Wythe,-4542,12336,3782,8324
VA,51195,Wise,-7290,14937,3751,11041
VA,51193,Westmoreland,39,8689,4155,4116
VA,51191,Washington,-11065,25582,7076,18141
VA,51187,Warren,-3416,16636,6449,9865
VA,51185,Tazewell,-10182,17712,3661,13843
VA,51183,Sussex,1329,5421,3350,2021
VA,51181,Surry,903,4302,2574,1671
VA,51179,Stafford,-5299,60338,27130,32429
VA,51177,Spotsylvania,-6668,57797,25150,31818
VA,51175,Southampton,-296,9261,4437,4733
VA,51173,Smyth,-4207,12751,4169,8376
VA,51171,Shenandoah,-6064,19289,6462,12526
VA,51169,Scott,-5044,9964,2395,7439
VA,51167,Russell,-4461,12063,3716,8177
VA,51165,Rockingham,-14114,34783,10059,24173
VA,51163,Rockbridge,-1811,10155,4087,5898
VA,51161,Roanoke,-13755,53793,19589,33344
VA,51159,Richmond,-586,3768,1574,2160
VA,51157,Rappahannock,-336,4331,1971,2307
VA,51155,Pulaski,-3630,14657,5287,8917
VA,51153,Prince William,28790,179648,103161,74371
VA,51149,Prince George,-1679,17180,7671,9350
VA,51147,Prince Edward,1180,9224,5132,3952
VA,51145,Powhatan,-7126,15466,4066,11192
VA,51143,Pittsylvania,-8420,30578,10855,19275
VA,51141,Patrick,-3205,8241,2417,5622
VA,51139,Page,-2620,10205,3724,6344
VA,51137,Orange,-2374,16330,6870,9244
VA,51135,Nottoway,-65,6844,3344,3409
VA,51133,Northumberland,-1122,7542,3186,4308
VA,51131,Northampton,1061,6481,3737,2676
VA,51127,New Kent,-3691,10941,3555,7246
VA,51125,Nelson,227,8225,4171,3944
VA,51121,Montgomery,-103,40938,19903,20006
VA,51119,Middlesex,-1249,6067,2370,3619
VA,51117,Mecklenburg,-1069,14813,6786,7855
VA,51115,Mathews,-1681,5364,1807,3488
VA,51113,Madison,-1227,6597,2637,3864
VA,51111,Lunenburg,-285,5726,2684,2969
VA,51109,Louisa,-2258,16404,6949,9207
VA,51107,Loudoun,7106,158648,81900,74794
VA,51105,Lee,-4252,9588,2593,6845
VA,51103,Lancaster,-605,7052,3144,3749
VA,51101,King William,-2119,8865,3326,5445
VA,51099,King George,-2127,11287,4476,6603
VA,51097,King and Queen,-120,3645,1743,1863
VA,51095,James City,-4976,41134,17854,22830
VA,51093,Isle of Wight,-3043,20772,8754,11797
VA,51091,Highland,-465,1411,459,924
VA,51089,Henry,-3668,24927,10312,13980
VA,51087,Henrico,18881,161195,89116,70235
VA,51085,Hanover,-21637,58936,18283,39920
VA,51083,Halifax,-939,16663,7760,8699
VA,51081,Greensville,1369,4925,3135,1766
VA,51079,Greene,-2274,8993,3284,5558
VA,51077,Grayson,-2707,7146,2094,4801
VA,51075,Goochland,-3772,13287,4676,8448
VA,51073,Gloucester,-5373,19246,6764,12137
VA,51071,Giles,-1930,7544,2730,4660
VA,51069,Frederick,-10168,36272,12683,22851
VA,51067,Franklin,-7603,26633,9082,16685
VA,51065,Fluvanna,-793,12724,5885,6678
VA,51063,Floyd,-1939,7626,2732,4671
VA,51061,Fauquier,-7064,35339,13891,20955
VA,51059,Fairfax,87049,440174,260835,173786
VA,51057,Essex,407,5666,3009,2602
VA,51053,Dinwiddie,-344,13339,6425,6769
VA,51051,Dickenson,-1802,6878,2472,4274
VA,51049,Cumberland,-116,5040,2422,2538
VA,51047,Culpeper,-3286,20131,8263,11549
VA,51045,Craig,-927,2664,830,1757
VA,51043,Clarke,-1058,7731,3237,4295
VA,51041,Chesterfield,-12220,172223,78954,91174
VA,51037,Charlotte,-809,5897,2502,3311
VA,51036,Charles City,1376,4213,2772,1396
VA,51035,Carroll,-4851,12315,3500,8351
VA,51033,Caroline,1110,13590,7258,6148
VA,51031,Campbell,-10096,25632,7591,17687
VA,51029,Buckingham,178,7447,3747,3569
VA,51027,Buchanan,-3342,9636,3094,6436
VA,51025,Brunswick,2028,8029,4993,2965
VA,51023,Botetourt,-7022,18208,5449,12471
VA,51021,Bland,-1409,2937,735,2144
VA,51019,Bedford,-18356,40750,10925,29281
VA,51017,Bath,-380,2218,894,1274
VA,51015,Augusta,-14166,33614,9448,23614
VA,51013,Arlington,46745,117279,81178,34433
VA,51011,Appomattox,-2887,7924,2453,5340
VA,51009,Amherst,-2967,14937,5898,8865
VA,51007,Amelia,-1836,6885,2488,4324
VA,51005,Alleghany,-192,7162,3403,3595
VA,51003,Albemarle,6449,53732,29712,23263
VA,51001,Accomack,-559,16020,7653,8212
VT,50027,Andover,69,314,187,118
VT,50027,Baltimore,17,115,63,46
VT,50027,Barnard,171,546,355,184
VT,50027,Bethel,340,971,646,306
VT,50027,Bridgewater,159,485,317,158
VT,50027,Cavendish,131,669,392,261
VT,50027,Chester,482,1486,971,489
VT,50027,Hartford,1910,4774,3315,1405
VT,50027,Hartland,765,1833,1290,525
VT,50027,Ludlow,215,1104,652,437
VT,50027,Norwich,1546,2160,1839,293
VT,50027,Plymouth,54,338,192,138
VT,50027,Pomfret,270,598,431,161
VT,50027,Reading,157,373,259,102
VT,50027,Rochester,290,648,463,173
VT,50027,Royalton,515,1259,870,355
VT,50027,Sharon,294,703,496,202
VT,50027,Springfield,992,3743,2331,1339
VT,50027,Stockbridge,141,384,260,119
VT,50027,Weathersfield,386,1424,895,509
VT,50027,Weston,152,417,282,130
VT,50027,West Windsor,235,679,454,219
VT,50027,Windsor,713,1554,1119,406
VT,50027,Woodstock,853,1891,1361,508
VT,50025,Athens,29,145,84,55
VT,50025,Brattleboro,3706,5630,4621,915
VT,50025,Brookline,103,258,179,76
VT,50025,Dover,132,742,428,296
VT,50025,Dummerston,663,1154,897,234
VT,50025,Grafton,122,357,235,113
VT,50025,Guilford,592,1131,853,261
VT,50025,Halifax,124,399,260,136
VT,50025,Jamaica,256,505,375,119
VT,50025,Londonderry,218,898,552,334
VT,50025,Marlboro,408,569,481,73
VT,50025,Newfane,532,948,732,200
VT,50025,Putney,876,1280,1064,188
VT,50025,Rockingham,1065,2098,1562,497
VT,50025,Stratton,3,143,73,70
VT,50025,Townshend,258,648,449,191
VT,50025,Vernon,67,1077,562,495
VT,50025,Wardsboro,116,382,246,130
VT,50025,Westminster,875,1579,1213,338
VT,50025,Whitingham,150,610,376,226
VT,50025,Wilmington,365,1034,692,327
VT,50025,Windham,76,218,146,70
VT,50023,Barre,898,3058,1946,1048
VT,50023,Barre Town,393,3903,2127,1734
VT,50023,Berlin,369,1250,795,426
VT,50023,Cabot,266,729,487,221
VT,50023,Calais,545,990,753,208
VT,50023,Duxbury,321,696,505,184
VT,50023,East Montpelier,749,1579,1151,402
VT,50023,Fayston,339,733,528,189
VT,50023,Marshfield,268,800,521,253
VT,50023,Middlesex,540,993,756,216
VT,50023,Montpelier,2992,4484,3692,700
VT,50023,Moretown,403,950,664,261
VT,50023,Northfield,693,2103,1378,685
VT,50023,Plainfield,391,648,509,118
VT,50023,Roxbury,137,333,228,91
VT,50023,Waitsfield,587,1085,824,237
VT,50023,Warren,577,991,774,197
VT,50023,Waterbury,1324,2697,1978,654
VT,50023,Woodbury,160,483,317,157
VT,50023,Worcester,305,544,416,111
VT,50021,Benson,142,470,301,159
VT,50021,Brandon,636,1798,1204,568
VT,50021,Castleton,291,1711,987,696
VT,50021,Chittenden,124,711,412,288
VT,50021,Clarendon,90,1227,648,558
VT,50021,Danby,138,629,374,236
VT,50021,Fair Haven,279,1102,678,399
VT,50021,Hubbardton,70,356,211,141
VT,50021,Ira,36,230,132,96
VT,50021,Killington,108,629,363,255
VT,50021,Mendon,57,590,319,262
VT,50021,Middletown Springs,109,441,272,163
VT,50021,Mount Holly,145,744,439,294
VT,50021,Mount Tabor,18,82,50,32
VT,50021,Pawlet,207,730,461,254
VT,50021,Pittsfield,44,281,160,116
VT,50021,Pittsford,347,1456,891,544
VT,50021,Poultney,389,1355,857,468
VT,50021,Proctor,204,798,498,294
VT,50021,Rutland,1823,6794,4251,2428
VT,50021,Rutland Town,182,2270,1211,1029
VT,50021,Shrewsbury,135,646,383,248
VT,50021,Sudbury,97,306,199,102
VT,50021,Tinmouth,68,291,177,109
VT,50021,Wallingford,237,1118,663,426
VT,50021,Wells,36,524,270,234
VT,50021,West Haven,35,125,79,44
VT,50021,West Rutland,206,1000,597,391
VT,50019,Albany,141,449,290,149
VT,50019,Barton,281,1072,671,390
VT,50019,Brownington,79,385,229,150
VT,50019,Charleston,87,431,256,169
VT,50019,Coventry,114,485,297,183
VT,50019,Craftsbury,284,619,435,151
VT,50019,Derby,386,2112,1234,848
VT,50019,Glover,240,574,398,158
VT,50019,Greensboro,198,407,299,101
VT,50019,Holland,50,296,171,121
VT,50019,Irasburg,56,528,290,234
VT,50019,Jay,54,196,123,69
VT,50019,Lowell,85,377,228,143
VT,50019,Morgan,-13,340,162,175
VT,50019,Newport,406,1550,961,555
VT,50019,Newport Town,135,685,405,270
VT,50019,Troy,157,637,393,236
VT,50019,Westfield,58,289,170,112
VT,50019,Westmore,12,199,104,92
VT,50017,Bradford,338,1194,754,416
VT,50017,Braintree,173,553,358,185
VT,50017,Brookfield,240,689,456,216
VT,50017,Chelsea,52,619,331,279
VT,50017,Corinth,168,661,408,240
VT,50017,Fairlee,208,528,361,153
VT,50017,Newbury,248,1017,623,375
VT,50017,Orange,3,510,251,248
VT,50017,Randolph,746,2120,1409,663
VT,50017,Strafford,447,693,561,114
VT,50017,Thetford,884,1538,1196,312
VT,50017,Topsham,80,508,288,208
VT,50017,Tunbridge,261,758,500,239
VT,50017,Vershire,127,342,230,103
VT,50017,Washington,120,522,315,195
VT,50017,West Fairlee,102,294,195,93
VT,50017,Williamstown,290,1418,839,549
VT,50015,Belvidere,25,142,82,57
VT,50015,Cambridge,820,1881,1332,512
VT,50015,Eden,174,475,320,146
VT,50015,Elmore,229,503,359,130
VT,50015,Hyde Park,616,1411,1003,387
VT,50015,Johnson,586,1274,919,333
VT,50015,Morristown,1112,2485,1780,668
VT,50015,Stowe,1005,2647,1805,800
VT,50015,Waterville,135,334,233,98
VT,50015,Wolcott,317,772,538,221
VT,50013,Alburg,277,915,591,314
VT,50013,Grand Isle,281,1203,729,448
VT,50013,Isle La Motte,62,292,175,113
VT,50013,North Hero,63,570,312,249
VT,50013,South Hero,377,1084,724,347
VT,50011,Bakersfield,196,583,386,190
VT,50011,Berkshire,123,567,342,219
VT,50011,Enosburgh,399,1219,797,398
VT,50011,Fairfax,449,2129,1275,826
VT,50011,Fairfield,246,869,552,306
VT,50011,Fletcher,233,613,418,185
VT,50011,Franklin,33,561,294,261
VT,50011,Georgia,310,2180,1228,918
VT,50011,Highgate,194,1292,736,542
VT,50011,Montgomery,236,592,410,174
VT,50011,Richford,240,763,497,257
VT,50011,St. Albans,841,2408,1593,752
VT,50011,St. Albans Town,445,2770,1592,1147
VT,50011,Sheldon,193,776,476,283
VT,50011,Swanton,514,2433,1461,947
VT,50009,Bloomfield,18,98,58,40
VT,50009,Brighton,76,531,299,223
VT,50009,Brunswick,16,60,38,22
VT,50009,Canaan,98,409,249,151
VT,50009,Concord,53,509,275,222
VT,50009,East Haven,17,122,68,51
VT,50009,Granby,13,44,28,15
VT,50009,Guildhall,10,145,75,65
VT,50009,Lemington,5,52,28,23
VT,50009,Lunenburg,53,554,296,243
VT,50009,Maidstone,-2,104,50,52
VT,50009,Norton,1,93,45,44
VT,50009,Victory,12,48,30,18
VT,50007,Bolton,272,603,433,161
VT,50007,Burlington,11731,17377,14322,2591
VT,50007,Charlotte,1020,2392,1677,657
VT,50007,Colchester,2067,7289,4615,2548
VT,50007,Essex,2990,10390,6630,3640
VT,50007,Hinesburg,1093,2423,1745,652
VT,50007,Huntington,618,1104,850,232
VT,50007,Jericho,964,3054,1990,1026
VT,50007,Milton,620,4630,2586,1966
VT,50007,Richmond,1072,2409,1722,650
VT,50007,St. George,116,326,219,103
VT,50007,Shelburne,1673,4520,3076,1403
VT,50007,South Burlington,3764,9403,6512,2748
VT,50007,Underhill,661,1821,1226,565
VT,50007,Westford,366,1133,742,376
VT,50007,Williston,1632,5104,3329,1697
VT,50007,Winooski,1389,2553,1941,552
VT,50005,Barnet,219,963,582,363
VT,50005,Burke,168,753,455,287
VT,50005,Danville,220,1183,695,475
VT,50005,Groton,8,443,219,211
VT,50005,Hardwick,540,1340,924,384
VT,50005,Kirby,80,242,158,78
VT,50005,Lyndon,274,2051,1140,866
VT,50005,Newark,57,293,168,111
VT,50005,Peacham,210,488,346,136
VT,50005,Ryegate,141,552,342,201
VT,50005,St. Johnsbury,708,2919,1789,1081
VT,50005,Sheffield,89,285,182,93
VT,50005,Stannard,49,92,68,19
VT,50005,Sutton,87,426,254,167
VT,50005,Walden,145,473,303,158
VT,50005,Waterford,44,705,370,326
VT,50005,Wheelock,65,337,197,132
VT,50003,Arlington,281,1241,749,468
VT,50003,Bennington,2750,6376,4503,1753
VT,50003,Dorset,338,1205,762,424
VT,50003,Landgrove,62,102,82,20
VT,50003,Manchester,590,2319,1440,850
VT,50003,Peru,105,218,160,55
VT,50003,Pownal,540,1582,1047,507
VT,50003,Readsboro,103,356,225,122
VT,50003,Rupert,101,381,238,137
VT,50003,Sandgate,39,207,121,82
VT,50003,Searsburg,3,51,24,21
VT,50003,Shaftsbury,490,1859,1163,673
VT,50003,Stamford,98,463,274,176
VT,50003,Sunderland,145,482,310,165
VT,50003,Winhall,108,499,297,189
VT,50003,Woodford,77,171,122,45
VT,50001,Addison,50,736,386,336
VT,50001,Bridport,63,634,340,277
VT,50001,Bristol,731,1787,1238,507
VT,50001,Cornwall,328,698,509,181
VT,50001,Ferrisburg,473,1534,987,514
VT,50001,Goshen,48,123,83,35
VT,50001,Granville,94,141,115,21
VT,50001,Hancock,52,149,99,47
VT,50001,Leicester,116,479,292,176
VT,50001,Lincoln,400,782,581,181
VT,50001,Middlebury,1974,3352,2635,661
VT,50001,Monkton,394,1070,724,330
VT,50001,New Haven,328,980,650,322
VT,50001,Orwell,58,618,333,275
VT,50001,Panton,86,333,208,122
VT,50001,Ripton,209,333,267,58
VT,50001,Salisbury,185,538,356,171
VT,50001,Shoreham,203,619,404,201
VT,50001,Starksboro,352,831,582,230
VT,50001,Vergennes,476,1113,788,312
VT,50001,Waltham,103,264,179,76
VT,50001,Weybridge,274,541,401,127
VT,50001,Whiting,79,188,133,54
UT,49057,Weber,-31369,68143,17569,48938
UT,49055,Wayne,-874,1323,213,1087
UT,49053,Washington,-33342,49733,7762,41104
UT,49051,Wasatch,-4755,9109,2097,6852
UT,49049,Utah,-126546,161278,15791,142337
UT,49047,Uintah,-9039,11116,962,10001
UT,49045,Tooele,-8446,16422,3794,12240
UT,49043,Summit,-808,16616,7656,8464
UT,49041,Sevier,-6260,7781,701,6961
UT,49039,Sanpete,-6878,8804,889,7767
UT,49037,San Juan,-944,5159,2062,3006
UT,49035,Salt Lake,-66053,341664,132686,198739
UT,49033,Rich,-824,999,83,907
UT,49031,Piute,-622,781,74,696
UT,49029,Morgan,-3524,4370,386,3910
UT,49027,Millard,-3997,4958,424,4421
UT,49025,Kane,-1745,3281,718,2463
UT,49023,Juab,-2964,3907,436,3400
UT,49021,Iron,-9452,13168,1720,11172
UT,49019,Grand,-239,3812,1678,1917
UT,49017,Garfield,-1505,2157,306,1811
UT,49015,Emery,-3174,4414,569,3743
UT,49013,Duchesne,-5038,6273,570,5608
UT,49011,Davis,-69613,112568,20417,90030
UT,49009,Daggett,-308,509,91,399
UT,49007,Carbon,-2630,7231,2204,4834
UT,49005,Cache,-25384,37099,5434,30818
UT,49003,Box Elder,-14139,18092,1830,15969
UT,49001,Beaver,-1812,2534,341,2153
TX,48507,Zavala,2468,3653,3042,574
TX,48505,Zapata,1524,3529,2517,993
TX,48503,Young,-5233,7316,992,6225
TX,48501,Yoakum,-1289,2128,409,1698
TX,48499,Wood,-11265,17541,3052,14317
TX,48497,Wise,-13959,20692,3219,17178
TX,48495,Winkler,-933,1745,398,1331
TX,48493,Wilson,-7386,17186,4819,12205
TX,48491,Williamson,-35098,162936,61812,96910
TX,48489,Willacy,2180,5058,3595,1415
TX,48487,Wilbarger,-1985,3980,971,2956
TX,48485,Wichita,-19266,40923,10490,29756
TX,48483,Wheeler,-1646,2128,232,1878
TX,48481,Wharton,-5515,14087,4235,9750
TX,48479,Webb,26518,49101,37592,11074
TX,48477,Washington,-7472,14373,3378,10850
TX,48475,Ward,-1528,3238,836,2364
TX,48473,Waller,-2757,15699,6401,9158
TX,48471,Walker,-4286,15066,5283,9569
TX,48469,Victoria,-10889,28827,8795,19684
TX,48467,Van Zandt,-12707,19081,3083,15790
TX,48465,Val Verde,655,12040,6267,5612
TX,48463,Uvalde,-702,8431,3824,4526
TX,48461,Upton,-620,1298,332,952
TX,48459,Upshur,-8995,15049,2953,11948
TX,48457,Tyler,-4230,7623,1659,5889
TX,48455,Trinity,-2923,6234,1614,4537
TX,48453,Travis,92037,384890,231540,139503
TX,48451,Tom Green,-17503,36527,9246,26749
TX,48449,Titus,-3424,8790,2638,6062
TX,48447,Throckmorton,-591,813,109,700
TX,48445,Terry,-1543,3707,1059,2602
TX,48443,Terrell,-174,553,184,358
TX,48441,Taylor,-23128,43170,9725,32853
TX,48439,Tarrant,-95897,610149,252789,348686
TX,48437,Swisher,-1075,2265,579,1654
TX,48435,Sutton,-741,1489,369,1110
TX,48433,Stonewall,-347,675,160,507
TX,48431,Sterling,-428,494,31,459
TX,48429,Stephens,-2416,3407,475,2891
TX,48427,Starr,8708,11859,10248,1540
TX,48425,Somervell,-2249,3507,609,2858
TX,48423,Smith,-39757,84794,22101,61858
TX,48421,Sherman,-787,1038,121,908
TX,48419,Shelby,-4552,9261,2318,6870
TX,48417,Shackelford,-1087,1363,131,1218
TX,48415,Scurry,-3284,5022,837,4121
TX,48413,Schleicher,-561,1010,220,781
TX,48411,San Saba,-1582,2256,323,1905
TX,48409,San Patricio,-4140,20064,7854,11994
TX,48407,San Jacinto,-4695,9610,2410,7105
TX,48405,San Augustine,-1276,3690,1193,2469
TX,48403,Sabine,-2920,4572,806,3726
TX,48401,Rusk,-9473,18537,4451,13924
TX,48399,Runnels,-2586,3665,517,3103
TX,48397,Rockwall,-18986,35651,8112,27098
TX,48395,Robertson,-1624,7278,2792,4416
TX,48393,Roberts,-383,439,25,408
TX,48391,Refugio,-661,2673,998,1659
TX,48389,Reeves,464,2867,1649,1185
TX,48387,Red River,-2067,5074,1482,3549
TX,48385,Real,-959,1533,277,1236
TX,48383,Reagan,-518,843,158,676
TX,48381,Randall,-33813,49588,7553,41366
TX,48379,Rains,-2511,4065,754,3265
TX,48377,Presidio,769,1808,1273,504
TX,48375,Potter,-11791,26418,7114,18905
TX,48373,Polk,-9183,19058,4836,14019
TX,48371,Pecos,-921,4147,1591,2512
TX,48369,Parmer,-1477,2545,528,2005
TX,48367,Parker,-31176,47346,7804,38980
TX,48365,Panola,-5730,10221,2211,7941
TX,48363,Palo Pinto,-5582,9335,1810,7392
TX,48361,Orange,-16564,30502,6797,23361
TX,48359,Oldham,-715,865,71,786
TX,48357,Ochiltree,-2465,2990,253,2718
TX,48355,Nueces,-3113,95781,45666,48779
TX,48353,Nolan,-2061,4567,1216,3277
TX,48351,Newton,-2678,6188,1721,4399
TX,48349,Navarro,-6490,15316,4348,10838
TX,48347,Nacogdoches,-7469,20601,6441,13910
TX,48345,Motley,-483,599,55,538
TX,48343,Morris,-1370,5129,1856,3226
TX,48341,Moore,-3004,4983,963,3967
TX,48339,Montgomery,-104970,172820,32852,137822
TX,48337,Montague,-5423,7737,1116,6539
TX,48335,Mitchell,-1218,2312,536,1754
TX,48333,Mills,-1603,2197,279,1882
TX,48331,Milam,-2846,8220,2632,5478
TX,48329,Midland,-27229,44277,8223,35452
TX,48327,Menard,-493,846,170,663
TX,48325,Medina,-6256,15948,4760,11016
TX,48323,Maverick,6131,10562,8302,2171
TX,48321,Matagorda,-4054,12110,3972,8026
TX,48319,Mason,-1182,1965,380,1562
TX,48317,Martin,-1091,1593,247,1338
TX,48315,Marion,-1243,4271,1487,2730
TX,48313,Madison,-2064,4025,964,3028
TX,48311,McMullen,-369,508,67,436
TX,48309,McLennan,-22197,74493,25688,47885
TX,48307,McCulloch,-1882,2993,537,2419
TX,48305,Lynn,-913,1852,464,1377
TX,48303,Lubbock,-37045,90615,26088,63133
TX,48301,Loving,-45,64,9,54
TX,48299,Llano,-5742,9502,1818,7560
TX,48297,Live Oak,-2238,4108,915,3153
TX,48295,Lipscomb,-925,1168,119,1044
TX,48293,Limestone,-3080,7563,2208,5288
TX,48291,Liberty,-12108,22711,5196,17304
TX,48289,Leon,-4751,6941,1061,5812
TX,48287,Lee,-2874,6211,1630,4504
TX,48285,La Vaca,-5361,8279,1427,6788
TX,48283,La Salle,296,1646,965,669
TX,48281,Lampasas,-4126,7138,1457,5583
TX,48279,Lamb,-2058,4089,998,3056
TX,48277,Lamar,-8641,17173,4173,12814
TX,48275,Knox,-828,1510,332,1160
TX,48273,Kleberg,696,8902,4752,4056
TX,48271,Kinney,-358,1425,522,880
TX,48269,King,-134,145,5,139
TX,48267,Kimble,-1450,1891,217,1667
TX,48265,Kerr,-12900,21811,4325,17225
TX,48263,Kent,-268,404,66,334
TX,48261,Kenedy,-1,166,82,83
TX,48259,Kendall,-11432,17729,3035,14467
TX,48257,Kaufman,-15353,34604,9451,24804
TX,48255,Karnes,-1499,4180,1324,2823
TX,48253,Jones,-3033,5562,1225,4258
TX,48251,Johnson,-27128,48753,10481,37609
TX,48249,Jim Wells,1897,11163,6492,4595
TX,48247,Jim Hogg,945,1667,1301,356
TX,48245,Jefferson,1412,88548,44626,43214
TX,48243,Jeff Davis,-277,1188,440,717
TX,48241,Jasper,-6522,13466,3402,9924
TX,48239,Jackson,-2835,5018,1068,3903
TX,48237,Jack,-2277,2907,303,2580
TX,48235,Irion,-556,788,112,668
TX,48233,Hutchinson,-5755,7916,1042,6797
TX,48231,Hunt,-14318,27984,6658,20976
TX,48229,Hudspeth,-92,861,379,471
TX,48227,Howard,-2990,5139,1042,4032
TX,48225,Houston,-3604,8129,2235,5839
TX,48223,Hopkins,-7059,12742,2775,9834
TX,48221,Hood,-14512,22445,3829,18341
TX,48219,Hockley,-4061,7119,1482,5543
TX,48217,Hill,-6383,12032,2745,9128
TX,48215,Hidalgo,58093,138966,97879,39786
TX,48213,Henderson,-15108,27582,6094,21202
TX,48211,Hemphill,-1106,1509,192,1298
TX,48209,Hays,-6129,58808,25448,31577
TX,48207,Haskell,-871,2006,551,1422
TX,48205,Hartley,-1517,1904,183,1700
TX,48203,Harrison,-9040,26099,8431,17471
TX,48201,Harris,585,1185478,585451,584866
TX,48199,Hardin,-14386,21293,3358,17744
TX,48197,Hardeman,-874,1495,302,1176
TX,48195,Hansford,-1629,1960,158,1787
TX,48193,Hamilton,-2327,3551,591,2918
TX,48191,Hall,-567,1108,265,832
TX,48189,Hale,-4189,8765,2228,6417
TX,48187,Guadalupe,-17305,49247,15654,32959
TX,48185,Grimes,-3802,8598,2339,6141
TX,48183,Gregg,-16329,41356,12336,28665
TX,48181,Grayson,-20242,42207,10665,30907
TX,48179,Gray,-5543,7373,885,6428
TX,48177,Gonzales,-2440,6039,1773,4213
TX,48175,Goliad,-1167,3452,1127,2294
TX,48173,Glasscock,-482,578,44,526
TX,48171,Gillespie,-8250,12535,2055,10305
TX,48169,Garza,-986,1556,276,1262
TX,48167,Galveston,-29432,109227,39162,68594
TX,48165,Gaines,-2949,4066,535,3484
TX,48163,Frio,817,3968,2376,1559
TX,48161,Freestone,-3796,7562,1848,5644
TX,48159,Franklin,-2696,4255,750,3446
TX,48157,Fort Bend,-14985,219250,101043,116028
TX,48155,Foard,-206,493,140,346
TX,48153,Floyd,-972,2085,551,1523
TX,48151,Fisher,-582,1628,512,1094
TX,48149,Fayette,-5787,10534,2311,8098
TX,48147,Fannin,-5661,10781,2482,8143
TX,48145,Falls,-1323,5432,2033,3356
TX,48143,Erath,-8360,12467,1965,10325
TX,48141,El Paso,55756,171053,112273,56517
TX,48139,Ellis,-25550,53756,13803,39353
TX,48137,Edwards,-409,883,232,641
TX,48135,Ector,-15841,32408,8095,23936
TX,48133,Eastland,-4473,6494,970,5443
TX,48131,Duval,2352,4343,3331,979
TX,48129,Donley,-1060,1533,226,1286
TX,48127,Dimmit,1379,2917,2141,762
TX,48125,Dickens,-577,1019,216,793
TX,48123,De Witt,-3651,6624,1463,5114
TX,48121,Denton,-76188,240125,79917,156105
TX,48119,Delta,-1070,2018,454,1524
TX,48117,Deaf Smith,-1803,4309,1239,3042
TX,48115,Dawson,-1574,3640,1017,2591
TX,48113,Dallas,108831,705941,403170,294339
TX,48111,Dallam,-995,1532,253,1248
TX,48109,Culberson,272,876,566,294
TX,48107,Crosby,-493,1787,639,1132
TX,48105,Crockett,-477,1457,480,957
TX,48103,Crane,-710,1283,275,985
TX,48101,Cottle,-373,739,180,553
TX,48099,Coryell,-6052,16551,5141,11193
TX,48097,Cooke,-9661,14291,2240,11901
TX,48095,Concho,-599,1001,194,793
TX,48093,Comanche,-3050,4897,890,3940
TX,48091,Comal,-27854,51475,11437,39291
TX,48089,Colorado,-3991,8095,2024,6015
TX,48087,Collingsworth,-785,1150,177,962
TX,48085,Collin,-95179,301101,100754,195933
TX,48083,Coleman,-2566,3483,441,3007
TX,48081,Coke,-1037,1406,179,1216
TX,48079,Cochran,-392,916,256,648
TX,48077,Clay,-3526,5056,740,4266
TX,48075,Childress,-1345,1996,320,1665
TX,48073,Cherokee,-8356,16387,3935,12291
TX,48071,Chambers,-8981,14692,2780,11761
TX,48069,Castro,-840,2119,630,1470
TX,48067,Cass,-5826,11764,2921,8747
TX,48065,Carson,-2158,2775,292,2450
TX,48063,Camp,-1450,4332,1428,2878
TX,48061,Cameron,24204,74802,49159,24955
TX,48059,Callahan,-3625,5195,751,4376
TX,48057,Calhoun,-1635,6746,2510,4145
TX,48055,Caldwell,-1231,11055,4787,6018
TX,48053,Burnet,-9156,16770,3672,12828
TX,48051,Burleson,-2966,6455,1705,4671
TX,48049,Brown,-9990,13936,1904,11894
TX,48047,Brooks,1379,2403,1886,507
TX,48045,Briscoe,-459,700,117,576
TX,48043,Brewster,-210,3866,1765,1975
TX,48041,Brazos,-19712,55845,17440,37152
TX,48039,Brazoria,-36357,106422,34327,70684
TX,48037,Bowie,-14656,35357,10184,24840
TX,48035,Bosque,-4507,7336,1366,5873
TX,48033,Borden,-292,362,32,324
TX,48031,Blanco,-2417,4971,1220,3637
TX,48029,Bexar,23352,511405,263871,240519
TX,48027,Bell,-14054,85765,35315,49369
TX,48025,Bee,-903,7873,3451,4354
TX,48023,Baylor,-1030,1592,267,1297
TX,48021,Bastrop,-4159,24457,9860,14019
TX,48019,Bandera,-5564,9434,1859,7423
TX,48017,Bailey,-870,1813,466,1336
TX,48015,Austin,-7008,11628,2252,9260
TX,48013,Atascosa,-2323,12704,5128,7451
TX,48011,Armstrong,-730,935,98,828
TX,48009,Archer,-3074,4163,525,3599
TX,48007,Aransas,-4126,9646,2703,6829
TX,48005,Angelina,-12468,28403,7833,20301
TX,48003,Andrews,-2842,4476,794,3636
TX,48001,Anderson,-8439,16167,3796,12235
TN,47189,Wilson,-21407,51437,14669,36076
TN,47187,Williamson,-43762,93606,24328,68090
TN,47185,White,-3399,9133,2793,6192
TN,47183,Weakley,-5054,12332,3547,8601
TN,47181,Wayne,-3088,5484,1163,4251
TN,47179,Washington,-18469,48003,14318,32787
TN,47177,Warren,-3259,13008,4748,8007
TN,47175,Van Buren,-509,2298,875,1384
TN,47173,Union,-2804,5820,1474,4278
TN,47171,Unicoi,-3119,7078,1909,5028
TN,47169,Trousdale,-372,2901,1238,1610
TN,47167,Tipton,-9375,23682,7020,16395
TN,47165,Sumner,-27408,65334,18571,45979
TN,47163,Sullivan,-28225,59833,15303,43528
TN,47161,Stewart,-894,5115,2069,2963
TN,47159,Smith,-2025,7081,2467,4492
TN,47157,Shelby,96665,370749,232201,135536
TN,47155,Sevier,-18564,33856,7415,25979
TN,47153,Sequatchie,-2053,5141,1488,3541
TN,47151,Scott,-3665,6668,1452,5117
TN,47149,Rutherford,-24429,98816,36400,60829
TN,47147,Robertson,-9352,26285,8289,17641
TN,47145,Roane,-8705,21081,6014,14719
TN,47143,Rhea,-5168,10578,2625,7793
TN,47141,Putnam,-9449,25479,7793,17242
TN,47139,Polk,-2252,6059,1856,4108
TN,47137,Pickett,-996,2446,711,1707
TN,47135,Perry,-586,2621,992,1578
TN,47133,Overton,-1970,7657,2802,4772
TN,47131,Obion,-5494,12296,3320,8814
TN,47129,Morgan,-2946,6500,1722,4668
TN,47127,Moore,-1348,2799,705,2053
TN,47125,Montgomery,-5810,55424,24349,30159
TN,47123,Monroe,-7349,16320,4368,11717
TN,47121,Meigs,-1565,3958,1163,2728
TN,47119,Maury,-8879,32989,11819,20698
TN,47117,Marshall,-3101,10729,3722,6823
TN,47115,Marion,-2316,10404,3952,6268
TN,47113,Madison,-3629,40691,18360,21989
TN,47111,Macon,-3707,6904,1552,5259
TN,47109,McNairy,-4367,9809,2643,7010
TN,47107,McMinn,-8355,17818,4603,12958
TN,47105,Loudon,-11644,22066,5057,16701
TN,47103,Lincoln,-6508,13249,3283,9791
TN,47101,Lewis,-1671,4691,1445,3116
TN,47099,Lawrence,-6533,15219,4237,10770
TN,47097,Lauderdale,-606,8688,4010,4616
TN,47095,Lake,-279,2087,884,1163
TN,47093,Knox,-48817,167330,57594,106411
TN,47091,Johnson,-3128,6194,1483,4611
TN,47089,Jefferson,-8807,17565,4230,13037
TN,47087,Jackson,-644,4178,1736,2380
TN,47085,Humphreys,-925,6860,2904,3829
TN,47083,Houston,-179,3027,1400,1579
TN,47081,Hickman,-2063,7595,2693,4756
TN,47079,Henry,-3850,12731,4337,8187
TN,47077,Henderson,-4902,10051,2516,7418
TN,47075,Haywood,1607,7567,4567,2960
TN,47073,Hawkins,-9290,19789,5086,14376
TN,47071,Hardin,-5419,10495,2467,7886
TN,47069,Hardeman,615,10435,5479,4864
TN,47067,Hancock,-1052,2046,475,1527
TN,47065,Hamilton,-21083,142320,58794,79877
TN,47063,Hamblen,-9286,20020,5229,14515
TN,47061,Grundy,-865,4217,1637,2502
TN,47059,Greene,-11018,23937,6216,17234
TN,47057,Grainger,-3801,7250,1668,5469
TN,47055,Giles,-3155,10797,3759,6914
TN,47053,Gibson,-6319,19667,6564,12883
TN,47051,Franklin,-4658,16099,5594,10252
TN,47049,Fentress,-3681,6890,1559,5240
TN,47047,Fayette,-5999,19562,6683,12682
TN,47045,Dyer,-6164,13800,3757,9921
TN,47043,Dickson,-5059,17821,6228,11287
TN,47041,DeKalb,-1966,6406,2168,4134
TN,47039,Decatur,-1571,4248,1302,2873
TN,47037,Davidson,44435,237372,138899,94464
TN,47035,Cumberland,-12391,25244,6260,18651
TN,47033,Crockett,-2113,5497,1669,3782
TN,47031,Coffee,-7148,19242,5865,13013
TN,47029,Cocke,-5655,11450,2804,8459
TN,47027,Clay,-710,2820,1037,1747
TN,47025,Claiborne,-5184,10178,2433,7617
TN,47023,Chester,-3050,6396,1622,4672
TN,47021,Cheatham,-5610,15177,4656,10266
TN,47019,Carter,-10710,20607,4786,15496
TN,47017,Carroll,-3744,10845,3475,7219
TN,47015,Cannon,-1748,4968,1560,3308
TN,47013,Campbell,-5275,12097,3327,8602
TN,47011,Bradley,-19382,35956,8035,27417
TN,47009,Blount,-22492,49200,12925,35417
TN,47007,Bledsoe,-1755,4359,1267,3022
TN,47005,Benton,-1595,6223,2255,3850
TN,47003,Bedford,-5819,14433,4207,10026
TN,47001,Anderson,-8829,29621,10112,18941
SD,46137,Ziebach,125,761,439,314
SD,46135,Yankton,-1255,9924,4208,5463
SD,46129,Walworth,-1060,2462,671,1731
SD,46127,Union,-1916,7596,2782,4698
SD,46125,Turner,-1304,4210,1411,2715
SD,46123,Tripp,-1168,2691,737,1905
SD,46121,Todd,1478,2497,1976,498
SD,46119,Sully,-425,816,186,611
SD,46117,Stanley,-628,1540,435,1063
SD,46115,Spink,-370,3041,1300,1670
SD,46113,Shannon,2734,3130,2922,188
SD,46111,Sanborn,-299,1115,389,688
SD,46109,Roberts,419,4256,2302,1883
SD,46107,Potter,-690,1381,339,1029
SD,46105,Perkins,-886,1590,319,1205
SD,46103,Pennington,-13107,44458,15122,28229
SD,46101,Moody,-106,3033,1429,1535
SD,46099,Minnehaha,-5662,76565,34668,40330
SD,46097,Miner,-157,1140,479,636
SD,46095,Mellette,-6,769,375,381
SD,46093,Meade,-4632,10811,2928,7560
SD,46091,Marshall,172,1987,1061,889
SD,46089,McPherson,-649,1215,272,921
SD,46087,McCook,-750,2613,905,1655
SD,46085,Lyman,-328,1569,605,933
SD,46083,Lincoln,-5629,21952,7982,13611
SD,46081,Lawrence,-3052,11359,3973,7025
SD,46079,Lake,-695,6285,2724,3419
SD,46077,Kingsbury,-359,2608,1092,1451
SD,46075,Jones,-382,609,108,490
SD,46073,Jerauld,-86,1006,452,538
SD,46071,Jackson,-235,1106,426,661
SD,46069,Hyde,-342,733,189,531
SD,46067,Hutchinson,-1528,3425,923,2451
SD,46065,Hughes,-2433,8155,2786,5219
SD,46063,Harding,-556,739,82,638
SD,46061,Hanson,-867,2416,760,1627
SD,46059,Hand,-667,1848,575,1242
SD,46057,Hamlin,-882,2793,921,1803
SD,46055,Haakon,-802,1092,138,940
SD,46053,Gregory,-908,2151,599,1507
SD,46051,Grant,-541,3606,1493,2034
SD,46049,Faulk,-434,1127,331,765
SD,46047,Fall River,-1119,3511,1137,2256
SD,46045,Edmunds,-642,1936,622,1264
SD,46043,Douglas,-1002,1690,332,1334
SD,46041,Dewey,544,1895,1207,663
SD,46039,Deuel,-234,2171,941,1175
SD,46037,Day,177,2873,1497,1320
SD,46035,Davison,-1712,7968,3042,4754
SD,46033,Custer,-1727,4520,1335,3062
SD,46031,Corson,132,1199,647,515
SD,46029,Codington,-2108,11524,4588,6696
SD,46027,Clay,809,5233,2955,2146
SD,46025,Clark,-354,1821,713,1067
SD,46023,Charles Mix,-747,3762,1482,2229
SD,46021,Campbell,-463,787,153,616
SD,46019,Butte,-2068,4201,1000,3068
SD,46017,Buffalo,306,641,472,166
SD,46015,Brule,-675,2379,824,1499
SD,46013,Brown,-1071,16066,7249,8320
SD,46011,Brookings,-393,12398,5826,6219
SD,46009,Bon Homme,-663,3074,1167,1830
SD,46007,Bennett,-78,1203,548,626
SD,46005,Beadle,-1349,7263,2881,4230
SD,46003,Aurora,-248,1400,556,804
SC,45091,York,-20392,99428,38757,59149
SC,45089,Williamsburg,6499,16282,11318,4819
SC,45087,Union,-818,12475,5748,6566
SC,45085,Sumter,8284,47261,27550,19266
SC,45083,Spartanburg,-25031,108327,40920,65951
SC,45081,Saluda,-1808,8553,3322,5130
SC,45079,Richland,47625,143016,94350,46725
SC,45077,Pickens,-22263,45422,11122,33385
SC,45075,Orangeburg,18566,42637,30454,11888
SC,45073,Oconee,-13036,30613,8537,21573
SC,45071,Newberry,-2327,16287,6891,9218
SC,45069,Marlboro,3544,11657,7554,4010
SC,45067,Marion,4404,14766,9518,5114
SC,45065,McCormick,177,5137,2637,2460
SC,45063,Lexington,-42385,112204,34007,76392
SC,45061,Lee,3143,8898,5972,2829
SC,45059,Laurens,-4429,25373,10297,14726
SC,45057,Lancaster,-5928,33010,13345,19273
SC,45055,Kershaw,-5025,27026,10821,15846
SC,45053,Jasper,1558,9991,5727,4169
SC,45051,Horry,-30033,104584,36620,66653
SC,45049,Hampton,2504,9184,5814,3310
SC,45047,Greenwood,-4406,28525,11884,16290
SC,45045,Greenville,-53136,191282,67378,120514
SC,45043,Georgetown,-2357,30870,14119,16476
SC,45041,Florence,-317,57877,28508,28825
SC,45039,Fairfield,3747,11858,7743,3996
SC,45037,Edgefield,-1546,11583,4965,6511
SC,45035,Dorchester,-9079,56735,23390,32469
SC,45033,Dillon,2146,13186,7623,5477
SC,45031,Darlington,1023,30140,15452,14429
SC,45029,Colleton,31,17077,8470,8439
SC,45027,Clarendon,2077,15985,8967,6890
SC,45025,Chesterfield,-546,16576,7942,8488
SC,45023,Chester,1503,14324,7839,6336
SC,45021,Cherokee,-6087,20753,7219,13306
SC,45019,Charleston,3779,160854,81027,77248
SC,45017,Calhoun,338,7830,4043,3705
SC,45015,Berkeley,-11525,61111,24239,35764
SC,45013,Beaufort,-12805,73115,29775,42580
SC,45011,Barnwell,527,9913,5182,4655
SC,45009,Bamberg,2410,6854,4600,2190
SC,45007,Anderson,-26178,71901,22315,48493
SC,45005,Allendale,2441,4257,3335,894
SC,45003,Aiken,-17204,66049,23953,41157
SC,45001,Abbeville,-1416,10577,4507,5923
RI,44009,Charlestown,820,4135,2433,1613
RI,44009,Exeter,200,3223,1672,1472
RI,44009,Hopkinton,523,3661,2044,1521
RI,44009,Narragansett,1036,7585,4229,3193
RI,44009,New Shoreham,388,966,664,276
RI,44009,North Kingstown,1383,14604,7828,6445
RI,44009,Richmond,422,3542,1925,1503
RI,44009,South Kingstown,3867,13594,8572,4705
RI,44009,Westerly,1599,9623,5537,3938
RI,44007,Burrillville,621,6843,3660,3039
RI,44007,Central Falls,2881,3938,3390,509
RI,44007,Cranston,8346,34782,21324,12978
RI,44007,Cumberland,2181,16607,9277,7096
RI,44007,East Providence,8310,20129,14050,5740
RI,44007,Foster,191,2429,1279,1088
RI,44007,Glocester,118,5005,2523,2405
RI,44007,Johnston,2086,13071,7493,5407
RI,44007,Lincoln,1146,10518,5754,4608
RI,44007,North Providence,4206,15213,9592,5386
RI,44007,North Smithfield,199,6003,3046,2847
RI,44007,Pawtucket,12823,23603,18042,5219
RI,44007,Providence,34711,49333,41588,6877
RI,44007,Scituate,-372,5380,2454,2826
RI,44007,Smithfield,516,9388,4875,4359
RI,44007,Woonsocket,3715,11850,7675,3960
RI,44005,Jamestown,776,3267,1985,1209
RI,44005,Little Compton,307,2160,1211,904
RI,44005,Middletown,1512,7168,4282,2770
RI,44005,Newport,3203,9241,6145,2942
RI,44005,Portsmouth,850,9321,5009,4159
RI,44005,Tiverton,516,9388,4875,4359
RI,44003,Coventry,2135,16406,9091,6956
RI,44003,East Greenwich,121,7270,3645,3524
RI,44003,Warwick,9402,40171,24403,15001
RI,44003,West Greenwich,10,2439,1202,1192
RI,44003,West Warwick,2512,10961,6625,4113
RI,44001,Barrington,1721,9517,5546,3825
RI,44001,Bristol,2637,10209,6341,3704
RI,44001,Warren,1369,4837,3056,1687
PA,42133,York,-39450,186394,72126,111576
PA,42131,Wyoming,-1377,11214,4812,6189
PA,42129,Westmoreland,-40049,168709,63380,103429
PA,42127,Wayne,-4393,20966,8138,12531
PA,42125,Washington,-11952,90078,38503,50455
PA,42123,Warren,-2647,16462,6768,9415
PA,42121,Venango,-5459,20775,7469,12928
PA,42119,Union,-3800,16187,6063,9863
PA,42117,Tioga,-5546,15943,5053,10599
PA,42115,Susquehanna,-3844,17930,6891,10735
PA,42113,Sullivan,-831,2934,1028,1859
PA,42111,Somerset,-14515,33875,9420,23935
PA,42109,Snyder,-5378,14962,4672,10050
PA,42107,Schuylkill,-7703,57505,24453,32156
PA,42105,Potter,-3307,7205,1892,5199
PA,42103,Pike,-2543,23164,10170,12713
PA,42101,Philadelphia,465184,653598,557024,91840
PA,42099,Perry,-7081,18240,5430,12511
PA,42097,Northumberland,-6124,31512,12392,18516
PA,42095,Northampton,5772,125883,65014,59242
PA,42093,Montour,-1610,7787,3026,4636
PA,42091,Montgomery,57658,401787,227561,169903
PA,42089,Monroe,8331,59312,33431,25100
PA,42087,Mifflin,-7634,16311,4259,11893
PA,42085,Mercer,-1222,48065,23082,24304
PA,42083,McKean,-4234,15014,5260,9494
PA,42081,Lycoming,-15386,46214,15104,30490
PA,42079,Luzerne,6005,123741,63974,57969
PA,42077,Lehigh,10938,144922,77029,66091
PA,42075,Lebanon,-15035,53771,18975,34010
PA,42073,Lawrence,-3488,38816,17427,20915
PA,42071,Lancaster,-42256,219677,87108,129364
PA,42069,Lackawanna,26579,97116,61309,34730
PA,42067,Juniata,-4288,9480,2533,6821
PA,42065,Jefferson,-7753,17072,4535,12288
PA,42063,Indiana,-6784,36180,14403,21187
PA,42061,Huntingdon,-6570,17587,5383,11953
PA,42059,Greene,-2421,13726,5564,7985
PA,42057,Fulton,-3483,6148,1297,4780
PA,42055,Franklin,-24162,62802,18910,43072
PA,42053,Forest,-487,2308,894,1381
PA,42051,Fayette,-4004,48196,21841,25845
PA,42049,Erie,19034,112732,65136,46102
PA,42047,Elk,-1955,12425,5144,7099
PA,42045,Delaware,59535,272853,164805,105270
PA,42043,Dauphin,7371,122625,64209,56838
PA,42041,Cumberland,-20382,109964,43983,64365
PA,42039,Crawford,-6473,33089,13024,19497
PA,42037,Columbia,-3021,24305,10424,13445
PA,42035,Clinton,-1438,12663,5503,6941
PA,42033,Clearfield,-9210,31894,11093,20303
PA,42031,Clarion,-5497,15227,4731,10228
PA,42029,Chester,-1048,248295,122232,123280
PA,42027,Centre,-20,68801,33677,33697
PA,42025,Carbon,-1670,24232,11040,12710
PA,42023,Cameron,-587,1967,677,1264
PA,42021,Cambria,-10283,57718,23181,33464
PA,42019,Butler,-31031,88924,28385,59416
PA,42017,Bucks,3722,319407,159598,155876
PA,42015,Bradford,-5536,22501,8291,13827
PA,42013,Blair,-15984,47631,15516,31500
PA,42011,Berks,-962,163253,79895,80857
PA,42009,Bedford,-11779,21444,4730,16509
PA,42007,Beaver,-5285,80015,36833,42118
PA,42005,Armstrong,-10537,28322,8694,19231
PA,42003,Allegheny,88847,614671,348151,259304
PA,42001,Adams,-11597,41973,14893,26490
OR,41071,Yamhill,-2805,41750,18906,21711
OR,41069,Wheeler,-280,841,262,542
OR,41067,Washington,37880,216473,124431,86551
OR,41065,Wasco,-86,10550,5066,5152
OR,41063,Wallowa,-1544,4152,1252,2796
OR,41061,Union,-3665,11905,3943,7608
OR,41059,Umatilla,-6926,24623,8499,15425
OR,41057,Tillamook,579,12346,6249,5670
OR,41055,Sherman,-360,1019,317,677
OR,41053,Polk,-1616,33996,15761,17377
OR,41051,Multnomah,189275,344614,261222,71947
OR,41049,Morrow,-1335,3838,1189,2524
OR,41047,Marion,-4098,115519,54337,58435
OR,41045,Malheur,-4050,9711,2701,6751
OR,41043,Linn,-8589,49987,19893,28482
OR,41041,Lincoln,4654,22612,13277,8623
OR,41039,Lane,38912,166176,99891,60979
OR,41037,Lake,-2032,3676,769,2801
OR,41035,Klamath,-10514,27530,8140,18654
OR,41033,Josephine,-8707,39679,14929,23636
OR,41031,Jefferson,-1338,7978,3238,4576
OR,41029,Jackson,-4633,91955,42341,46974
OR,41027,Hood River,2577,9662,5977,3400
OR,41025,Harney,-1770,3535,829,2599
OR,41023,Grant,-2014,3778,834,2848
OR,41021,Gilliam,-266,1044,371,637
OR,41019,Douglas,-13556,49062,17032,30588
OR,41017,Deschutes,-5685,77441,34985,40670
OR,41015,Curry,-1966,11529,4611,6577
OR,41013,Crook,-3688,10109,3081,6769
OR,41011,Coos,-1770,27926,12628,14398
OR,41009,Columbia,1198,23298,11843,10645
OR,41007,Clatsop,2515,17206,9616,7101
OR,41005,Clackamas,6462,185564,94013,87551
OR,41003,Benton,12740,44262,27662,14922
OR,41001,Baker,-3328,8351,2364,5692
OK,40153,Woodward,-4807,7065,1129,5936
OK,40151,Woods,-2055,3395,670,2725
OK,40149,Washita,-2661,4303,821,3482
OK,40147,Washington,-10135,21199,5532,15667
OK,40145,Wagoner,-13075,28621,7773,20848
OK,40143,Tulsa,-62275,227541,82633,144908
OK,40141,Tillman,-907,2719,906,1813
OK,40139,Texas,-4054,5762,854,4908
OK,40137,Stephens,-8968,16846,3939,12907
OK,40135,Sequoyah,-5380,13766,4193,9573
OK,40133,Seminole,-2255,7449,2597,4852
OK,40131,Rogers,-18385,36677,9146,27531
OK,40129,Roger Mills,-1130,1674,272,1402
OK,40127,Pushmataha,-2044,4130,1043,3087
OK,40125,Pottawatomie,-9058,23422,7182,16240
OK,40123,Pontotoc,-4987,12855,3934,8921
OK,40121,Pittsburg,-5972,15598,4813,10785
OK,40119,Payne,-7274,25660,9193,16467
OK,40117,Pawnee,-2415,6041,1813,4228
OK,40115,Ottawa,-2957,9973,3508,6465
OK,40113,Osage,-4523,17913,6695,11218
OK,40111,Okmulgee,-2296,13128,5416,7712
OK,40109,Oklahoma,-42713,256337,106812,149525
OK,40107,Okfuskee,-1077,3579,1251,2328
OK,40105,Nowata,-1588,4076,1244,2832
OK,40103,Noble,-2342,4626,1142,3484
OK,40101,Muskogee,-3449,23335,9943,13392
OK,40099,Murray,-2066,5146,1540,3606
OK,40097,Mayes,-4812,14456,4822,9634
OK,40095,Marshall,-2348,5140,1396,3744
OK,40093,Major,-2254,3146,446,2700
OK,40091,McIntosh,-1731,7265,2767,4498
OK,40089,McCurtain,-5193,10073,2440,7633
OK,40087,McClain,-7917,14299,3191,11108
OK,40085,Love,-1402,3470,1034,2436
OK,40083,Logan,-7611,16983,4686,12297
OK,40081,Lincoln,-6277,12807,3265,9542
OK,40079,LeFlore,-6514,15830,4658,11172
OK,40077,Latimer,-1451,3789,1169,2620
OK,40075,Kiowa,-1208,3410,1101,2309
OK,40073,Kingfisher,-3666,5354,844,4510
OK,40071,Kay,-6874,16122,4624,11498
OK,40069,Johnston,-1510,3778,1134,2644
OK,40067,Jefferson,-1030,2234,602,1632
OK,40065,Jackson,-4009,7915,1953,5962
OK,40063,Hughes,-1466,4206,1370,2836
OK,40061,Haskell,-1894,4244,1175,3069
OK,40059,Harper,-1088,1434,173,1261
OK,40057,Harmon,-395,923,264,659
OK,40055,Greer,-856,1832,488,1344
OK,40053,Grant,-1281,2067,393,1674
OK,40051,Grady,-10038,19598,4780,14818
OK,40049,Garvin,-4366,9478,2556,6922
OK,40047,Garfield,-10444,19908,4732,15176
OK,40045,Ellis,-1349,1801,226,1575
OK,40043,Dewey,-1468,2070,301,1769
OK,40041,Delaware,-5880,14232,4176,10056
OK,40039,Custer,-5084,9800,2358,7442
OK,40037,Creek,-11850,26078,7114,18964
OK,40035,Craig,-1806,5298,1746,3552
OK,40033,Cotton,-1139,2453,657,1796
OK,40031,Comanche,-5140,30174,12517,17657
OK,40029,Coal,-1061,2357,648,1709
OK,40027,Cleveland,-24318,93720,34701,59019
OK,40025,Cimarron,-967,1197,115,1082
OK,40023,Choctaw,-2078,5066,1494,3572
OK,40021,Cherokee,-2014,14288,6137,8151
OK,40019,Carter,-7306,17120,4907,12213
OK,40017,Canadian,-25082,46148,10533,35615
OK,40015,Caddo,-2509,8811,3151,5660
OK,40013,Bryan,-5655,12721,3533,9188
OK,40011,Blaine,-1833,3815,991,2824
OK,40009,Beckham,-4083,6909,1413,5496
OK,40007,Beaver,-1814,2300,243,2057
OK,40005,Atoka,-2293,4775,1241,3534
OK,40003,Alfalfa,-1261,1817,278,1539
OK,40001,Adair,-2252,6472,2110,4362
OH,39175,Wyandot,-2092,10254,3962,6054
OH,39173,Wood,2599,61967,31596,28997
OH,39171,Williams,-2818,17286,7045,9863
OH,39169,Wayne,-10518,49356,18932,29450
OH,39167,Washington,-5588,28798,11333,16921
OH,39165,Warren,-42719,108008,31907,74626
OH,39163,Vinton,-416,5352,2382,2798
OH,39161,Van Wert,-5510,13586,3923,9433
OH,39159,Union,-7401,24947,8546,15947
OH,39157,Tuscarawas,-3904,39855,17516,21420
OH,39155,Trumbull,21901,98703,59446,37545
OH,39153,Summit,38446,259389,147146,108700
OH,39151,Stark,-644,176620,86314,86958
OH,39149,Shelby,-10635,23129,6065,16700
OH,39147,Seneca,-2063,24633,10962,13025
OH,39145,Scioto,-591,30023,14432,15023
OH,39143,Sandusky,544,28192,14035,13491
OH,39141,Ross,-687,28961,13895,14582
OH,39139,Richland,-11272,55954,21785,33057
OH,39137,Putnam,-9325,18126,4238,13563
OH,39135,Preble,-7197,19619,6005,13202
OH,39133,Portage,3617,74029,38082,34465
OH,39131,Pike,-45,11233,5490,5535
OH,39129,Pickaway,-4378,23443,9335,13713
OH,39127,Perry,-641,14673,6857,7498
OH,39125,Paulding,-1813,8912,3435,5248
OH,39123,Ottawa,891,21936,11214,10323
OH,39121,Noble,-1416,5755,2082,3498
OH,39119,Muskingum,-2499,35954,16327,18826
OH,39117,Morrow,-3882,15813,5780,9662
OH,39115,Morgan,-364,6042,2772,3136
OH,39113,Montgomery,7795,254266,128983,121188
OH,39111,Monroe,-533,6743,3007,3540
OH,39109,Miami,-17919,50281,15731,33650
OH,39107,Mercer,-11598,21161,4609,16207
OH,39105,Meigs,-1871,9979,3911,5782
OH,39103,Medina,-11623,88849,37841,49464
OH,39101,Marion,-2005,26433,11933,13938
OH,39099,Mahoning,32596,117571,74298,41702
OH,39097,Madison,-3515,17240,6700,10215
OH,39095,Lucas,61129,200850,129229,68100
OH,39093,Lorain,20017,138513,78112,58095
OH,39091,Logan,-6534,20535,6789,13323
OH,39089,Licking,-11340,77423,32264,43604
OH,39087,Lawrence,-3917,25252,10454,14371
OH,39085,Lake,-1931,114264,55219,57150
OH,39083,Knox,-6719,27618,10154,16873
OH,39081,Jefferson,-1769,32327,14960,16729
OH,39079,Jackson,-2686,12916,4965,7651
OH,39077,Huron,-2148,24077,10673,12821
OH,39075,Holmes,-5995,11355,2568,8563
OH,39073,Hocking,-140,12442,6010,6150
OH,39071,Highland,-5260,17161,5772,11032
OH,39069,Henry,-2598,13937,5513,8111
OH,39067,Harrison,-1041,6999,2895,3936
OH,39065,Hardin,-2850,12147,4487,7337
OH,39063,Hancock,-9885,34940,12192,22077
OH,39061,Hamilton,19855,402572,208508,188653
OH,39059,Guernsey,-1585,16403,7226,8811
OH,39057,Greene,-17655,81075,31028,48683
OH,39055,Geauga,-10809,50125,19295,30104
OH,39053,Gallia,-2494,9534,3418,5912
OH,39051,Fulton,-2731,20757,8790,11521
OH,39049,Franklin,117713,541751,325654,207941
OH,39047,Fayette,-2381,10677,4075,6456
OH,39045,Fairfield,-11303,70079,28831,40134
OH,39043,Erie,4314,38262,20969,16655
OH,39041,Delaware,-22849,96330,36131,58980
OH,39039,Defiance,-2497,17744,7438,9935
OH,39037,Darke,-11135,24807,6610,17745
OH,39035,Cuyahoga,236478,611512,420953,184475
OH,39033,Crawford,-4354,19192,7207,11561
OH,39031,Coshocton,-1471,15555,6841,8312
OH,39029,Columbiana,-5427,45078,19351,24778
OH,39027,Clinton,-6206,17648,5534,11740
OH,39025,Clermont,-33193,93392,29334,62527
OH,39023,Clark,-1094,62136,30022,31116
OH,39021,Champaign,-4026,20016,7826,11852
OH,39019,Carroll,-1781,12965,5396,7177
OH,39017,Butler,-42944,164020,59282,102226
OH,39015,Brown,-4748,18955,6923,11671
OH,39013,Belmont,-2592,30876,13826,16418
OH,39011,Auglaize,-11159,22838,5643,16802
OH,39009,Athens,9150,26112,17268,8118
OH,39007,Ashtabula,5074,41781,22964,17890
OH,39005,Ashland,-7142,23826,8083,15225
OH,39003,Allen,-11933,46458,16869,28802
OH,39001,Adams,-2834,10787,3857,6691
ND,38105,Williams,-4799,9600,2288,7087
ND,38103,Wells,-975,2359,671,1646
ND,38101,Ward,-7764,25231,8412,16176
ND,38099,Walsh,-691,5061,2118,2809
ND,38097,Traill,-179,3841,1784,1963
ND,38095,Towner,-108,1164,511,619
ND,38093,Stutsman,-2080,9431,3561,5641
ND,38091,Steele,20,1028,515,495
ND,38089,Stark,-5704,11539,2805,8509
ND,38087,Slope,-258,434,83,341
ND,38085,Sioux,677,1138,900,223
ND,38083,Sheridan,-476,808,161,637
ND,38081,Sargent,197,1987,1073,876
ND,38079,Rolette,2261,4528,3351,1090
ND,38077,Richland,-1023,7549,3190,4213
ND,38075,Renville,-452,1272,398,850
ND,38073,Ransom,333,2412,1341,1008
ND,38071,Ramsey,-497,4971,2162,2659
ND,38069,Pierce,-806,2162,656,1462
ND,38067,Pembina,-648,3226,1245,1893
ND,38065,Oliver,-412,1010,281,693
ND,38063,Nelson,-96,1668,766,862
ND,38061,Mountrail,-559,3444,1401,1960
ND,38059,Morton,-4202,13510,4467,8669
ND,38057,Mercer,-1971,4394,1161,3132
ND,38055,McLean,-1470,4894,1660,3130
ND,38053,McKenzie,-1524,3423,926,2450
ND,38051,McIntosh,-572,1510,456,1028
ND,38049,McHenry,-727,2653,924,1651
ND,38047,Logan,-578,1042,221,799
ND,38045,LaMoure,-637,2179,737,1374
ND,38043,Kidder,-477,1310,393,870
ND,38041,Hettinger,-685,1351,313,998
ND,38039,Griggs,-235,1335,535,770
ND,38037,Grant,-681,1383,331,1012
ND,38035,Grand Forks,-1036,29796,14008,15044
ND,38033,Golden Valley,-579,924,161,740
ND,38031,Foster,-424,1674,604,1028
ND,38029,Emmons,-1047,1862,383,1430
ND,38027,Eddy,-147,1147,484,631
ND,38025,Dunn,-1001,2002,493,1494
ND,38023,Divide,-349,1151,382,731
ND,38021,Dickey,-752,2513,849,1601
ND,38019,Cavalier,-374,2054,818,1192
ND,38017,Cass,-2160,73275,34632,36792
ND,38015,Burleigh,-13775,42876,14036,27811
ND,38013,Burke,-536,1015,230,766
ND,38011,Bowman,-865,1728,412,1277
ND,38009,Bottineau,-1083,3484,1163,2246
ND,38007,Billings,-383,577,89,472
ND,38005,Benson,365,2148,1232,867
ND,38003,Barnes,-564,5471,2389,2953
ND,38001,Adams,-588,1281,328,916
NC,37199,Yancey,-1295,9344,3954,5249
NC,37197,Yadkin,-8572,16657,3928,12500
NC,37195,Wilson,2841,38890,20745,17904
NC,37193,Wilkes,-12321,28852,8089,20410
NC,37191,Wayne,-4382,50988,23154,27536
NC,37189,Watauga,-753,28168,13371,14124
NC,37187,Washington,1196,6456,3811,2615
NC,37185,Warren,3524,9777,6635,3111
NC,37183,Wake,54006,526805,286939,232933
NC,37181,Vance,5880,20770,13286,7406
NC,37179,Union,-28436,93389,32032,60468
NC,37177,Tyrrell,-94,1775,835,929
NC,37175,Transylvania,-2782,16469,6740,9522
NC,37173,Swain,-358,5705,2618,2976
NC,37171,Surry,-10748,29096,9005,19753
NC,37169,Stokes,-9173,21396,5969,15142
NC,37167,Stanly,-11411,28276,8287,19698
NC,37165,Scotland,2332,14020,8131,5799
NC,37163,Sampson,-2862,26005,11496,14358
NC,37161,Rutherford,-9520,28373,9277,18797
NC,37159,Rowan,-16093,61803,22529,38622
NC,37157,Rockingham,-8867,41549,16170,25037
NC,37155,Robeson,6864,41380,23957,17093
NC,37153,Richmond,511,19127,9747,9236
NC,37151,Randolph,-30238,60202,14675,44913
NC,37149,Polk,-2219,10323,4000,6219
NC,37147,Pitt,5167,76814,40701,35534
NC,37145,Person,-2083,19008,8384,10467
NC,37143,Perquimans,-1067,6621,2747,3814
NC,37141,Pender,-4913,24036,9455,14368
NC,37139,Pasquotank,2754,17343,9970,7216
NC,37137,Pamlico,-1400,6712,2632,4032
NC,37135,Orange,32006,75848,53404,21398
NC,37133,Onslow,-13580,50353,18115,31695
NC,37131,Northampton,3736,10719,7210,3474
NC,37129,New Hanover,-4754,102067,48038,52792
NC,37127,Nash,445,48235,24214,23769
NC,37125,Moore,-12965,46044,16371,29336
NC,37123,Montgomery,-1700,11178,4689,6389
NC,37121,Mitchell,-3968,7673,1810,5778
NC,37119,Mecklenburg,100215,445062,270705,170490
NC,37117,Martin,551,12541,6514,5963
NC,37115,Madison,-913,10023,4466,5379
NC,37113,Macon,-5125,16750,5692,10817
NC,37111,McDowell,-5726,17953,6006,11732
NC,37109,Lincoln,-14204,36532,10980,25184
NC,37107,Lenoir,-413,27247,13350,13763
NC,37105,Lee,-2423,23800,10577,13000
NC,37103,Jones,-490,5192,2335,2825
NC,37101,Johnston,-21154,76021,27052,48206
NC,37099,Jackson,-172,16556,8052,8224
NC,37097,Iredell,-23119,75762,25952,49071
NC,37095,Hyde,-26,2358,1157,1183
NC,37093,Hoke,3194,16800,9915,6721
NC,37091,Hertford,4814,10872,7815,3001
NC,37089,Henderson,-14341,51961,18519,32860
NC,37087,Haywood,-3811,27679,11742,15553
NC,37085,Harnett,-8212,42343,16858,25070
NC,37083,Halifax,8245,25724,16931,8686
NC,37081,Guilford,41519,251529,145483,103964
NC,37079,Greene,-632,8194,3761,4393
NC,37077,Granville,1197,26068,13529,12332
NC,37075,Graham,-1628,3910,1115,2743
NC,37073,Gates,213,5310,2745,2532
NC,37071,Gaston,-22914,89638,32903,55817
NC,37069,Franklin,-1163,28059,13317,14480
NC,37067,Forsyth,12429,172332,91606,79177
NC,37065,Edgecombe,9755,26826,18249,8494
NC,37063,Durham,75859,143828,109185,33326
NC,37061,Duplin,-2407,20375,8923,11330
NC,37059,Davie,-8916,20418,5652,14568
NC,37057,Davidson,-28644,69994,20291,48935
NC,37055,Dare,-2844,17614,7258,10102
NC,37053,Currituck,-3910,11153,3521,7431
NC,37051,Cumberland,24800,126092,74991,50191
NC,37049,Craven,-8098,45585,18556,26654
NC,37047,Columbus,-1890,24017,10973,12863
NC,37045,Cleveland,-8706,42542,16734,25440
NC,37043,Clay,-2379,5592,1573,3952
NC,37041,Chowan,-365,7424,3507,3872
NC,37039,Cherokee,-5862,12695,3339,9201
NC,37037,Chatham,1674,35157,18252,16578
NC,37035,Catawba,-20432,69102,23954,44386
NC,37033,Caswell,-288,10736,5183,5471
NC,37031,Carteret,-14401,35124,10197,24598
NC,37029,Camden,-1539,4520,1456,2995
NC,37027,Caldwell,-12274,34338,10795,23069
NC,37025,Cabarrus,-16672,82445,32453,49125
NC,37023,Burke,-8532,36116,13577,22109
NC,37021,Buncombe,15637,126201,70066,54429
NC,37019,Brunswick,-12655,56985,21932,34587
NC,37017,Bladen,330,16351,8277,7947
NC,37015,Bertie,3170,9941,6537,3367
NC,37013,Beaufort,-4519,23468,9399,13918
NC,37011,Avery,-3847,7657,1861,5708
NC,37009,Ashe,-4107,12486,4100,8207
NC,37007,Anson,2769,11072,6894,4125
NC,37005,Alleghany,-1804,5025,1574,3378
NC,37003,Alexander,-7616,17060,4591,12207
NC,37001,Alamance,-9371,66638,28341,37712
NY,36123,Yates,-249,8437,4021,4270
NY,36121,Wyoming,-4502,15230,5224,9726
NY,36119,Westchester,63201,284731,171908,108707
NY,36117,Wayne,-3179,34127,15136,18315
NY,36115,Washington,342,21263,10596,10254
NY,36113,Warren,541,26220,13112,12571
NY,36111,Ulster,15824,72193,43164,27340
NY,36109,Tompkins,14245,35825,24447,10202
NY,36107,Tioga,-3015,19977,8263,11278
NY,36105,Sullivan,2633,25322,13781,11148
NY,36103,Suffolk,15482,540653,274830,259348
NY,36101,Steuben,-5839,35659,14586,20425
NY,36099,Seneca,1121,12148,6526,5405
NY,36097,Schuyler,-588,7464,3354,3942
NY,36095,Schoharie,-1987,11943,4862,6849
NY,36093,Schenectady,9169,59614,33777,24608
NY,36091,Saratoga,2047,97502,48876,46829
NY,36089,Saint Lawrence,5660,34023,19574,13914
NY,36087,Rockland,7510,114500,60446,52936
NY,36085,Staten Island,1104,135283,67524,66420
NY,36083,Rensselaer,7473,63332,34713,27240
NY,36081,Queens,296777,507722,399970,103193
NY,36079,Putnam,-4585,40883,17851,22436
NY,36077,Otsego,448,21938,10975,10527
NY,36075,Oswego,3230,41133,21733,18503
NY,36073,Orleans,-2665,13756,5411,8076
NY,36071,Orange,6725,130494,67709,60984
NY,36069,Ontario,-713,44144,21285,21998
NY,36067,Onondaga,39857,188787,112664,72807
NY,36065,Oneida,-4251,80429,37388,41639
NY,36063,Niagara,465,82720,40862,40397
NY,36061,Manhattan,345561,496293,417861,72300
NY,36059,Nassau,30767,460824,243649,212882
NY,36057,Montgomery,-741,16784,7881,8622
NY,36055,Monroe,53722,308925,178491,124769
NY,36053,Madison,87,25865,12698,12611
NY,36051,Livingston,-2321,24606,10889,13210
NY,36049,Lewis,-820,9481,4263,5083
NY,36047,Brooklyn,394661,618035,503291,108630
NY,36045,Jefferson,-934,32051,15345,16279
NY,36043,Herkimer,-1956,23290,10433,12389
NY,36041,Hamilton,-697,2655,955,1652
NY,36039,Greene,-2024,18263,7911,9935
NY,36037,Genesee,-4815,23079,8886,13701
NY,36035,Fulton,-1895,18040,7916,9811
NY,36033,Franklin,3817,14537,9065,5248
NY,36031,Essex,2340,15577,8835,6495
NY,36029,Erie,60506,386665,220184,159678
NY,36027,Dutchess,7565,114142,59885,52320
NY,36025,Delaware,-1616,16916,7469,9085
NY,36023,Cortland,1559,17698,9445,7886
NY,36021,Columbia,3050,26008,14244,11194
NY,36019,Clinton,7069,27622,17123,10054
NY,36017,Chenango,-593,17655,8340,8933
NY,36015,Chemung,-922,31981,15285,16207
NY,36013,Chautauqua,-3980,48434,21815,25795
NY,36011,Cayuga,2807,26073,14162,11355
NY,36009,Cattaraugus,-3711,27608,11695,15406
NY,36007,Broome,3437,75244,38315,34878
NY,36005,Bronx,262074,316047,288378,26304
NY,36003,Allegany,-3951,15601,5658,9609
NY,36001,Albany,38862,125531,80891,42029
NM,35061,Valencia,685,27647,13473,12788
NM,35059,Union,-760,1753,471,1231
NM,35057,Torrance,-1107,6376,2414,3521
NM,35055,Taos,9145,15188,11855,2710
NM,35053,Socorro,1285,7087,3983,2698
NM,35051,Sierra,-965,5101,1963,2928
NM,35049,Santa Fe,34523,67624,49668,15145
NM,35047,San Miguel,6473,11388,8754,2281
NM,35045,San Juan,-13091,45994,15688,28779
NM,35043,Sandoval,2707,53361,26831,24124
NM,35041,Roosevelt,-2313,5949,1719,4032
NM,35039,Rio Arriba,8016,15239,11389,3373
NM,35037,Quay,-812,3696,1382,2194
NM,35035,Otero,-5504,19643,6715,12219
NM,35033,Mora,1361,2604,1952,591
NM,35031,McKinley,9943,21313,15363,5420
NM,35029,Luna,-81,7472,3573,3654
NM,35028,Los Alamos,395,10654,5191,4796
NM,35027,Lincoln,-3009,9209,2931,5940
NM,35025,Lea,-8412,16933,4068,12480
NM,35023,Hidalgo,99,1929,994,895
NM,35021,Harding,-66,600,260,326
NM,35019,Guadalupe,870,1978,1388,518
NM,35017,Grant,1723,12744,7009,5286
NM,35015,Eddy,-6436,19195,6110,12546
NM,35013,Dona Ana,9790,65712,36778,26988
NM,35011,DeBaca,-299,900,287,586
NM,35009,Curry,-5194,13450,3956,9150
NM,35007,Colfax,116,5896,2879,2763
NM,35006,Cibola,1941,8154,4907,2966
NM,35005,Chaves,-6650,20498,6621,13271
NM,35003,Catron,-917,2100,557,1474
NM,35001,Bernalillo,42941,264942,147183,104242
NJ,34041,Warren,-6826,43312,17869,24695
NJ,34039,Union,67763,202353,134220,66457
NJ,34037,Sussex,-13809,61704,23406,37215
NJ,34035,Somerset,7009,134932,70168,63159
NJ,34033,Salem,242,29116,14456,14214
NJ,34031,Passaic,44876,164629,104057,59181
NJ,34029,Ocean,-42094,237432,96500,138594
NJ,34027,Morris,-23952,206580,90313,114265
NJ,34025,Monmouth,-14905,268943,125471,140376
NJ,34023,Middlesex,77043,285232,179515,102472
NJ,34021,Mercer,51145,139064,94300,43155
NJ,34019,Hunterdon,-11831,62821,25148,36979
NJ,34017,Hudson,98157,176104,136239,38082
NJ,34015,Gloucester,14045,133568,72960,58915
NJ,34013,Essex,156355,281633,217950,61595
NJ,34011,Cumberland,11405,49472,30172,18767
NJ,34009,Cape May,-4213,47243,21275,25488
NJ,34007,Camden,74466,203201,137795,63329
NJ,34005,Burlington,36841,197059,115951,79110
NJ,34003,Bergen,38203,352023,193470,155267
NJ,34001,Atlantic,17591,102405,59509,41918
NH,33019,Acworth,104,539,316,212
NH,33019,Charlestown,509,2253,1365,856
NH,33019,Claremont,1205,5576,3352,2147
NH,33019,Cornish,240,1042,635,395
NH,33019,Croydon,-37,439,196,233
NH,33019,Goshen,25,436,227,202
NH,33019,Grantham,313,1992,1144,831
NH,33019,Langdon,59,392,223,164
NH,33019,Lempster,-22,617,294,316
NH,33019,Newport,138,2883,1448,1310
NH,33019,Plainfield,519,1453,976,457
NH,33019,Springfield,-33,772,365,398
NH,33019,Sunapee,-159,2018,916,1075
NH,33019,Unity,65,794,424,359
NH,33019,Washington,-29,608,285,314
NH,33017,Barrington,306,4926,2577,2271
NH,33017,Dover,3562,16163,9724,6162
NH,33017,Durham,2857,7398,5074,2217
NH,33017,Farmington,116,3006,1545,1429
NH,33017,Lee,700,2580,1621,921
NH,33017,Madbury,207,1153,673,466
NH,33017,Middleton,-23,869,416,439
NH,33017,Milton,-20,2249,1104,1124
NH,33017,New Durham,-190,1608,699,889
NH,33017,Rochester,677,14538,7493,6816
NH,33017,Rollinsford,157,1545,837,680
NH,33017,Somersworth,877,5248,3028,2151
NH,33017,Strafford,21,2479,1235,1214
NH,33015,Atkinson,-1061,4353,1630,2691
NH,33015,Auburn,-777,3244,1219,1996
NH,33015,Brentwood,-208,2431,1093,1301
NH,33015,Candia,-591,2487,937,1528
NH,33015,Chester,-540,2737,1082,1622
NH,33015,Danville,-373,2368,983,1356
NH,33015,Deerfield,-352,2655,1133,1485
NH,33015,Derry,-736,16109,7573,8309
NH,33015,East Kingston,-324,1529,592,916
NH,33015,Epping,96,3549,1793,1697
NH,33015,Exeter,1580,8890,5194,3614
NH,33015,Fremont,-341,2463,1039,1380
NH,33015,Greenland,196,2536,1355,1159
NH,33015,Hampstead,-1205,5278,2012,3217
NH,33015,Hampton,101,9670,4843,4742
NH,33015,Hampton Falls,-369,1492,548,917
NH,33015,Kensington,-152,1345,587,739
NH,33015,Kingston,-336,3421,1518,1854
NH,33015,Londonderry,-1635,13081,5660,7295
NH,33015,New Castle,-23,819,396,419
NH,33015,Newfields,43,1091,564,521
NH,33015,Newington,-36,565,262,298
NH,33015,Newmarket,1337,5199,3230,1893
NH,33015,Newton,-291,2530,1104,1395
NH,33015,North Hampton,-96,3049,1462,1558
NH,33015,Northwood,9,2430,1198,1189
NH,33015,Nottingham,-15,2797,1364,1379
NH,33015,Plaistow,-678,4140,1709,2387
NH,33015,Portsmouth,4740,13066,8828,4088
NH,33015,Raymond,-343,4991,2289,2632
NH,33015,Rye,57,3822,1930,1873
NH,33015,Salem,-2259,14446,6026,8285
NH,33015,Sandown,-624,3255,1298,1922
NH,33015,Seabrook,-181,4284,2030,2211
NH,33015,South Hampton,-82,569,240,322
NH,33015,Stratham,16,4837,2411,2395
NH,33015,Windham,-2260,8266,2964,5224
NH,33013,Allenstown,168,2167,1149,981
NH,33013,Andover,206,1370,777,571
NH,33013,Boscawen,234,1803,1000,766
NH,33013,Bow,157,4902,2509,2352
NH,33013,Bradford,47,976,503,456
NH,33013,Canterbury,276,1556,905,629
NH,33013,Chichester,-53,1544,731,784
NH,33013,Concord,6845,21604,14097,7252
NH,33013,Danbury,-6,629,307,313
NH,33013,Dunbarton,-164,1772,794,958
NH,33013,Epsom,-138,2556,1195,1333
NH,33013,Franklin,489,3677,2059,1570
NH,33013,Henniker,506,2561,1515,1009
NH,33013,Hill,19,562,286,267
NH,33013,Hooksett,-649,7357,3319,3968
NH,33013,Hopkinton,793,3768,2264,1471
NH,33013,Loudon,-132,2994,1414,1546
NH,33013,Newbury,-16,1353,664,680
NH,33013,New London,353,3151,1737,1384
NH,33013,Northfield,229,2282,1242,1013
NH,33013,Pembroke,373,3874,2102,1729
NH,33013,Pittsfield,23,1934,959,936
NH,33013,Salisbury,13,800,400,387
NH,33013,Sutton,109,1206,654,545
NH,33013,Warner,244,1657,938,694
NH,33013,Webster,127,1137,623,496
NH,33013,Wilmot,131,862,492,361
NH,33011,Amherst,-405,7508,3501,3906
NH,33011,Antrim,155,1480,810,655
NH,33011,Bedford,-3277,12804,4713,7990
NH,33011,Bennington,32,771,395,363
NH,33011,Brookline,-345,2943,1278,1623
NH,33011,Deering,3,1034,508,505
NH,33011,Francestown,89,1037,538,449
NH,33011,Goffstown,-625,9201,4231,4856
NH,33011,Greenfield,67,874,461,394
NH,33011,Greenville,85,955,509,424
NH,33011,Hancock,273,1216,738,465
NH,33011,Hillsborough,277,2753,1490,1213
NH,33011,Hollis,-496,5135,2289,2785
NH,33011,Hudson,277,10777,5451,5174
NH,33011,Litchfield,-747,4711,1956,2703
NH,33011,Lyndeborough,55,1029,535,480
NH,33011,Manchester,4867,47596,25676,20809
NH,33011,Mason,-145,838,331,476
NH,33011,Merrimack,-881,14676,6797,7678
NH,33011,Milford,167,7828,3940,3773
NH,33011,Mont Vernon,-84,1485,691,775
NH,33011,Nashua,5707,41244,23213,17506
NH,33011,New Boston,-337,3166,1399,1736
NH,33011,New Ipswich,-869,2549,819,1688
NH,33011,Pelham,-1314,7121,2870,4184
NH,33011,Peterborough,1170,3830,2479,1309
NH,33011,Sharon,71,259,162,91
NH,33011,Temple,22,862,435,413
NH,33011,Weare,-487,4767,2105,2592
NH,33011,Wilton,115,2205,1137,1022
NH,33011,Windsor,-24,111,42,66
NH,33009,Alexandria,40,926,472,432
NH,33009,Ashland,65,1138,587,522
NH,33009,Bath,-8,544,264,272
NH,33009,Benton,-17,179,79,96
NH,33009,Bethlehem,328,1417,862,534
NH,33009,Bridgewater,-9,699,343,352
NH,33009,Bristol,-42,1621,779,821
NH,33009,Campton,285,1842,1050,765
NH,33009,Canaan,380,1821,1089,709
NH,33009,Dorchester,-5,195,92,97
NH,33009,Easton,59,187,122,63
NH,33009,Ellsworth,13,52,32,19
NH,33009,Enfield,699,2421,1542,843
NH,33009,Franconia,203,761,479,276
NH,33009,Grafton,24,685,339,315
NH,33009,Groton,-16,298,139,155
NH,33009,Hanover,3742,7267,5469,1727
NH,33009,Haverhill,-1,1977,974,975
NH,33009,Hebron,-51,396,171,222
NH,33009,Holderness,208,1315,755,547
NH,33009,Landaff,24,244,133,109
NH,33009,Lebanon,2712,6906,4772,2060
NH,33009,Lincoln,109,797,446,337
NH,33009,Lisbon,64,716,386,322
NH,33009,Littleton,273,2901,1566,1293
NH,33009,Lyman,21,305,161,140
NH,33009,Lyme,658,1217,932,274
NH,33009,Monroe,-51,497,216,267
NH,33009,Orange,35,180,107,72
NH,33009,Orford,216,706,455,239
NH,33009,Piermont,94,423,255,161
NH,33009,Plymouth,1202,3532,2313,1111
NH,33009,Rumney,-27,862,411,438
NH,33009,Sugar Hill,95,405,248,153
NH,33009,Thornton,132,1378,743,611
NH,33009,Warren,27,446,233,206
NH,33009,Waterville,31,242,136,105
NH,33009,Wentworth,-42,490,218,260
NH,33009,Woodstock,149,777,456,307
NH,33007,Berlin,1615,4151,2863,1248
NH,33007,Carroll,48,506,274,226
NH,33007,Clarksville,-11,159,72,83
NH,33007,Colebrook,-34,990,472,506
NH,33007,Columbia,-28,340,155,183
NH,33007,Dalton,1,492,241,240
NH,33007,Dixville,0,10,5,5
NH,33007,Dummer,5,165,84,79
NH,33007,Errol,-15,179,81,96
NH,33007,Gorham,496,1560,1020,524
NH,33007,Jefferson,-37,596,274,311
NH,33007,Lancaster,122,1632,864,742
NH,33007,Milan,152,724,435,283
NH,33007,Millsfield,-11,22,5,16
NH,33007,Northumberland,255,997,621,366
NH,33007,Pittsburg,-137,501,180,317
NH,33007,Randolph,95,249,172,77
NH,33007,Shelburne,21,259,139,118
NH,33007,Stark,31,297,164,133
NH,33007,Stewartstown,-32,358,161,193
NH,33007,Stratford,62,275,167,105
NH,33007,Wentworth's Location,-4,23,9,13
NH,33007,Whitefield,155,1129,633,478
NH,33005,Alstead,251,1027,634,383
NH,33005,Chesterfield,340,2179,1251,911
NH,33005,Dublin,296,1060,671,375
NH,33005,Fitzwilliam,203,1317,753,550
NH,33005,Gilsum,39,432,231,192
NH,33005,Harrisville,270,693,478,208
NH,33005,Hinsdale,723,1762,1227,504
NH,33005,Jaffrey,303,2815,1538,1235
NH,33005,Keene,5075,12444,8667,3592
NH,33005,Marlborough,453,1161,801,348
NH,33005,Marlow,108,426,262,154
NH,33005,Nelson,145,454,295,150
NH,33005,Richmond,5,678,330,325
NH,33005,Rindge,-306,3188,1410,1716
NH,33005,Roxbury,69,152,110,41
NH,33005,Stoddard,66,751,403,337
NH,33005,Sullivan,73,377,221,148
NH,33005,Surry,51,494,270,219
NH,33005,Swanzey,636,3663,2133,1497
NH,33005,Troy,140,992,553,413
NH,33005,Walpole,491,2107,1284,793
NH,33005,Westmoreland,265,1096,676,411
NH,33005,Winchester,498,1803,1131,633
NH,33003,Albany,78,403,235,157
NH,33003,Bartlett,265,1829,1039,774
NH,33003,Brookfield,-80,434,171,251
NH,33003,Chatham,-5,217,105,110
NH,33003,Conway,838,5182,2982,2144
NH,33003,Eaton,44,282,163,119
NH,33003,Effingham,-13,790,380,393
NH,33003,Freedom,-40,921,438,478
NH,33003,Harts Location,14,33,23,9
NH,33003,Jackson,164,687,423,259
NH,33003,Madison,197,1408,793,596
NH,33003,Moultonborough,-618,3049,1204,1822
NH,33003,Ossipee,-181,2121,961,1142
NH,33003,Sandwich,206,1014,609,403
NH,33003,Tamworth,125,1578,843,718
NH,33003,Tuftonboro,-313,1668,671,984
NH,33003,Wakefield,-365,2561,1083,1448
NH,33003,Wolfeboro,-546,4287,1854,2400
NH,33001,Alton,-940,3371,1207,2147
NH,33001,Barnstead,-129,2410,1125,1254
NH,33001,Belmont,-34,3642,1782,1816
NH,33001,Center Harbor,-98,716,308,406
NH,33001,Gilford,-315,4616,2133,2448
NH,33001,Gilmanton,-138,2185,1013,1151
NH,33001,Laconia,76,7863,3932,3856
NH,33001,Meredith,-235,3975,1853,2088
NH,33001,New Hampton,10,1294,646,636
NH,33001,Sanbornton,-25,1821,888,913
NH,33001,Tilton,144,1878,997,853
NV,32510,Carson City,-2104,23318,10290,12394
NV,32033,White Pine,-1618,3704,983,2601
NV,32031,Washoe,6655,186917,94806,88151
NV,32029,Storey,-401,2314,920,1321
NV,32027,Pershing,-535,1884,632,1167
NV,32023,Nye,-4246,17522,6320,10566
NV,32021,Mineral,-217,2035,863,1080
NV,32019,Lyon,-6140,21465,7380,13520
NV,32017,Lincoln,-1291,2152,400,1691
NV,32015,Lander,-1046,2165,534,1580
NV,32013,Humboldt,-2073,5744,1737,3810
NV,32011,Eureka,-556,808,107,663
NV,32009,Esmeralda,-225,435,92,317
NV,32007,Elko,-8503,15984,3510,12013
NV,32005,Douglas,-6976,26054,9288,16264
NV,32003,Clark,99755,688339,387978,288223
NV,32001,Churchill,-4100,10265,2961,7061
NE,31185,York,-3462,6246,1352,4814
NE,31183,Wheeler,-252,446,93,345
NE,31181,Webster,-815,1730,440,1255
NE,31179,Wayne,-1419,3659,1074,2493
NE,31177,Washington,-3754,10121,3103,6857
NE,31175,Valley,-1149,2168,494,1643
NE,31173,Thurston,330,1993,1153,823
NE,31171,Thomas,-318,408,42,360
NE,31169,Thayer,-1129,2627,724,1853
NE,31167,Stanton,-1338,2623,607,1945
NE,31165,Sioux,-522,735,101,623
NE,31163,Sherman,-370,1508,549,919
NE,31161,Sheridan,-1621,2450,389,2010
NE,31159,Seward,-2585,7445,2362,4947
NE,31157,Scotts Bluff,-5234,13867,4193,9427
NE,31155,Saunders,-3446,10203,3279,6725
NE,31153,Sarpy,-15609,66166,24709,40318
NE,31151,Saline,-286,4832,2232,2518
NE,31149,Rock,-566,784,103,669
NE,31147,Richardson,-1227,3680,1180,2407
NE,31145,Red Willow,-2915,4868,940,3855
NE,31143,Polk,-1359,2446,527,1886
NE,31141,Platte,-6868,13249,3095,9963
NE,31139,Pierce,-2070,3414,637,2707
NE,31137,Phelps,-2497,4336,875,3372
NE,31135,Perkins,-896,1391,237,1133
NE,31133,Pawnee,-501,1330,396,897
NE,31131,Otoe,-1684,6905,2542,4226
NE,31129,Nuckolls,-996,2170,567,1563
NE,31127,Nemaha,-890,3126,1089,1979
NE,31125,Nance,-621,1604,477,1098
NE,31123,Morrill,-1208,2152,450,1658
NE,31121,Merrick,-1556,3457,921,2477
NE,31119,Madison,-6506,13512,3368,9874
NE,31117,McPherson,-196,290,41,237
NE,31115,Loup,-228,356,62,290
NE,31113,Logan,-288,431,68,356
NE,31111,Lincoln,-6195,15266,4350,10545
NE,31109,Lancaster,-1207,123206,59970,61177
NE,31107,Knox,-1823,4015,1055,2878
NE,31105,Kimball,-831,1665,391,1222
NE,31103,Keya Paha,-312,481,80,392
NE,31101,Keith,-2116,4026,920,3036
NE,31099,Kearney,-1580,3156,761,2341
NE,31097,Johnson,-433,2057,790,1223
NE,31095,Jefferson,-971,3416,1185,2156
NE,31093,Howard,-976,2856,914,1890
NE,31091,Hooker,-271,394,59,330
NE,31089,Holt,-2927,4749,862,3789
NE,31087,Hitchcock,-1076,1739,310,1386
NE,31085,Hayes,-423,535,50,473
NE,31083,Harlan,-937,1584,311,1248
NE,31081,Hamilton,-2446,4824,1136,3582
NE,31079,Hall,-5441,19721,6971,12412
NE,31077,Greeley,-480,1181,340,820
NE,31075,Grant,-292,363,30,322
NE,31073,Gosper,-502,975,230,732
NE,31071,Garfield,-615,928,147,762
NE,31069,Garden,-587,1088,242,829
NE,31067,Gage,-1600,9552,3870,5470
NE,31065,Furnas,-1345,2215,422,1767
NE,31063,Frontier,-624,1422,381,1005
NE,31061,Franklin,-729,1527,381,1110
NE,31059,Fillmore,-1178,2815,794,1972
NE,31057,Dundy,-615,981,176,791
NE,31055,Douglas,-9058,210501,99261,108319
NE,31053,Dodge,-3349,14759,5588,8937
NE,31051,Dixon,-875,2666,870,1745
NE,31049,Deuel,-548,1012,215,763
NE,31047,Dawson,-3213,7680,2157,5370
NE,31045,Dawes,-1333,3634,1102,2435
NE,31043,Dakota,-217,5977,2831,3048
NE,31041,Custer,-3185,5414,1066,4251
NE,31039,Cuming,-1843,3928,1015,2858
NE,31037,Colfax,-1086,3047,959,2045
NE,31035,Clay,-1551,2916,662,2213
NE,31033,Cheyenne,-2151,4197,983,3134
NE,31031,Cherry,-2121,3052,436,2557
NE,31029,Chase,-1321,1849,252,1573
NE,31027,Cedar,-2279,4260,952,3231
NE,31025,Cass,-3155,11952,4298,7453
NE,31023,Butler,-1701,3818,1028,2729
NE,31021,Burt,-736,3343,1280,2016
NE,31019,Buffalo,-8112,19057,5266,13378
NE,31017,Brown,-1075,1545,223,1298
NE,31015,Boyd,-666,1047,186,852
NE,31013,Box Butte,-1161,4541,1634,2795
NE,31011,Boone,-1521,2799,615,2136
NE,31009,Blaine,-239,301,29,268
NE,31007,Banner,-284,402,55,339
NE,31005,Arthur,-197,261,30,227
NE,31003,Antelope,-2014,3209,571,2585
NE,31001,Adams,-4244,12451,3991,8235
MT,30111,Yellowstone,-14146,68561,26275,40421
MT,30109,Wibaux,-396,544,25,421
MT,30107,Wheatland,-418,989,272,690
MT,30105,Valley,-951,3860,1386,2337
MT,30103,Treasure,-203,453,114,317
MT,30101,Toole,-858,2102,582,1440
MT,30099,Teton,-1018,3250,1073,2091
MT,30097,Sweet Grass,-1111,2105,473,1584
MT,30095,Stillwater,-2028,4560,1209,3237
MT,30093,Silver Bow,5408,16617,10782,5374
MT,30091,Sheridan,-542,1920,661,1203
MT,30089,Sanders,-2255,5888,1716,3971
MT,30087,Rosebud,-557,3610,1478,2035
MT,30085,Roosevelt,541,3618,2044,1503
MT,30083,Richland,-2487,4602,992,3479
MT,30081,Ravalli,-6351,19797,6466,12817
MT,30079,Prairie,-351,701,167,518
MT,30077,Powell,-914,2763,884,1798
MT,30075,Powder River,-663,1019,170,833
MT,30073,Pondera,-697,2704,969,1666
MT,30071,Phillips,-1217,2228,471,1688
MT,30069,Petroleum,-191,298,49,240
MT,30067,Park,-909,8634,3728,4637
MT,30065,Musselshell,-1310,2353,482,1792
MT,30063,Missoula,11095,59374,34380,23285
MT,30061,Mineral,-514,2009,698,1212
MT,30059,Meagher,-401,972,269,670
MT,30057,Madison,-1830,4511,1285,3115
MT,30055,McCone,-521,988,221,742
MT,30053,Lincoln,-3501,8869,2544,6045
MT,30051,Liberty,-441,983,257,698
MT,30049,Lewis and Clark,-1194,33032,15479,16673
MT,30047,Lake,-1369,13156,5715,7084
MT,30045,Judith Basin,-516,1212,336,852
MT,30043,Jefferson,-1786,6490,2256,4042
MT,30041,Hill,239,6757,3372,3133
MT,30039,Granite,-574,1705,533,1107
MT,30037,Golden Valley,-241,479,110,351
MT,30035,Glacier,1393,4287,2784,1391
MT,30033,Garfield,-556,700,66,622
MT,30031,Gallatin,-2517,47113,21534,24051
MT,30029,Flathead,-14160,42465,13534,27694
MT,30027,Fergus,-2615,6044,1628,4243
MT,30025,Fallon,-887,1399,236,1123
MT,30023,Deer Lodge,1398,4408,2829,1431
MT,30021,Dawson,-1805,4417,1219,3024
MT,30019,Daniels,-499,1001,236,735
MT,30017,Custer,-1529,5336,1824,3353
MT,30015,Chouteau,-782,2804,969,1751
MT,30013,Cascade,-3090,33952,14949,18039
MT,30011,Carter,-582,794,96,678
MT,30009,Carbon,-1387,5806,2126,3513
MT,30007,Broadwater,-1389,3005,761,2150
MT,30005,Blaine,429,2832,1598,1169
MT,30003,Big Horn,1175,4561,2830,1655
MT,30001,Beaverhead,-1904,4749,1347,3251
MO,29510,St. Louis City,94037,141135,116654,22617
MO,29229,Wright,-3878,7956,1953,5831
MO,29227,Worth,-323,1048,341,664
MO,29225,Webster,-6295,15421,4407,10702
MO,29223,Wayne,-1979,5718,1811,3790
MO,29221,Washington,-1606,8616,3402,5008
MO,29219,Warren,-3931,14676,5219,9150
MO,29217,Vernon,-3176,8519,2580,5756
MO,29215,Texas,-4747,10764,2871,7618
MO,29213,Taney,-10251,21608,5462,15713
MO,29211,Sullivan,-702,2595,908,1610
MO,29209,Stone,-7860,15974,3920,11780
MO,29207,Stoddard,-6343,12866,3153,9496
MO,29205,Shelby,-1222,3232,966,2188
MO,29203,Shannon,-960,3688,1300,2260
MO,29201,Scott,-6501,16999,5122,11623
MO,29199,Scotland,-603,1936,643,1246
MO,29197,Schuyler,-477,1939,697,1174
MO,29195,Saline,-1311,9095,3785,5096
MO,29189,St. Louis County,71633,524628,294735,223102
MO,29187,St. Francois,-4411,22590,8837,13248
MO,29186,Ste. Genevieve,-242,8070,3813,4055
MO,29185,St. Clair,-1559,4626,1460,3019
MO,29183,St. Charles,-38934,185597,71798,110732
MO,29181,Ripley,-2347,5263,1396,3743
MO,29179,Reynolds,-772,3196,1155,1927
MO,29177,Ray,-1541,10346,4264,5805
MO,29175,Randolph,-3636,9944,3031,6667
MO,29173,Ralls,-1495,5036,1736,3231
MO,29171,Putnam,-1086,2309,587,1673
MO,29169,Pulaski,-4893,13571,4199,9092
MO,29167,Polk,-5672,13119,3580,9252
MO,29165,Platte,-6446,45547,19171,25617
MO,29163,Pike,-1995,7319,2581,4576
MO,29161,Phelps,-6095,18188,5798,11893
MO,29159,Pettis,-4938,17171,5902,10840
MO,29157,Perry,-3485,7987,2184,5669
MO,29155,Pemiscot,-925,6333,2671,3596
MO,29153,Ozark,-1819,4453,1261,3080
MO,29151,Osage,-3858,6918,1472,5330
MO,29149,Oregon,-1467,4421,1419,2886
MO,29147,Nodaway,-2421,8976,3172,5593
MO,29145,Newton,-11754,25080,6425,18179
MO,29143,New Madrid,-1470,7250,2814,4284
MO,29141,Morgan,-2960,8688,2773,5733
MO,29139,Montgomery,-1752,5317,1734,3486
MO,29137,Monroe,-1166,4057,1398,2564
MO,29135,Moniteau,-3095,6442,1608,4703
MO,29133,Mississippi,-1139,4918,1857,2996
MO,29131,Miller,-5448,11019,2651,8099
MO,29129,Mercer,-902,1655,353,1255
MO,29127,Marion,-3892,12164,4034,7926
MO,29125,Maries,-1866,4538,1299,3165
MO,29123,Madison,-1639,4930,1588,3227
MO,29121,Macon,-2391,7159,2309,4700
MO,29119,McDonald,-3774,7817,1920,5694
MO,29117,Livingston,-2100,6054,1906,4006
MO,29115,Linn,-1300,5527,2031,3331
MO,29113,Lincoln,-6597,22649,7733,14330
MO,29111,Lewis,-1170,4278,1507,2677
MO,29109,Lawrence,-7403,15748,4014,11417
MO,29107,Lafayette,-4150,15786,5650,9800
MO,29105,LaClede,-6841,15361,4093,10934
MO,29103,Knox,-507,1957,698,1205
MO,29101,Johnson,-5089,21001,7661,12750
MO,29099,Jefferson,-12403,97613,41570,53973
MO,29097,Jasper,-18537,45213,12808,31345
MO,29095,Jackson,58209,306854,180100,121891
MO,29093,Iron,-583,4031,1669,2252
MO,29091,Howell,-7148,16341,4393,11541
MO,29089,Howard,-1290,4861,1722,3012
MO,29087,Holt,-1174,2310,551,1725
MO,29085,Hickory,-1102,4680,1733,2835
MO,29083,Henry,-2625,10121,3604,6229
MO,29081,Harrison,-1640,3695,984,2624
MO,29079,Grundy,-1818,4374,1212,3030
MO,29077,Greene,-30656,125639,46130,76786
MO,29075,Gentry,-1049,2997,937,1986
MO,29073,Gasconade,-2796,7134,2099,4895
MO,29071,Franklin,-12977,46573,16294,29271
MO,29069,Dunklin,-3214,10649,3635,6849
MO,29067,Douglas,-2940,6556,1709,4649
MO,29065,Dent,-3298,6643,1585,4883
MO,29063,DeKalb,-1862,4350,1194,3056
MO,29061,Daviess,-1158,3512,1124,2282
MO,29059,Dallas,-2870,7279,2122,4992
MO,29057,Dade,-1956,3896,939,2895
MO,29055,Crawford,-3483,9579,2951,6434
MO,29053,Cooper,-2413,7511,2474,4887
MO,29051,Cole,-12485,37058,12003,24488
MO,29049,Clinton,-2219,9830,3685,5904
MO,29047,Clay,-8881,105465,47250,56131
MO,29045,Clark,-332,3225,1398,1730
MO,29043,Christian,-17656,37952,9809,27465
MO,29041,Chariton,-1063,3821,1339,2402
MO,29039,Cedar,-2839,6043,1536,4375
MO,29037,Cass,-13868,48913,17044,30912
MO,29035,Carter,-1224,2799,754,1978
MO,29033,Carroll,-1918,4304,1154,3072
MO,29031,Cape Girardeau,-15630,35672,9713,25343
MO,29029,Camden,-8631,21942,6458,15089
MO,29027,Callaway,-5672,18228,6070,11742
MO,29025,Caldwell,-1411,4171,1313,2724
MO,29023,Butler,-7885,16889,4363,12248
MO,29021,Buchanan,-3066,35106,15594,18660
MO,29019,Boone,2439,79296,39782,37343
MO,29017,Bollinger,-2881,5455,1213,4094
MO,29015,Benton,-3144,9157,2925,6069
MO,29013,Bates,-2463,7771,2557,5020
MO,29011,Barton,-3184,5746,1232,4416
MO,29009,Barry,-6165,13806,3667,9832
MO,29007,Audrain,-2648,9951,3538,6186
MO,29005,Atchison,-1146,2709,756,1902
MO,29003,Andrew,-2808,8306,2649,5457
MO,29001,Adair,-1430,10121,4218,5648
MS,28163,Yazoo,1660,10853,6220,4560
MS,28161,Yalobusha,-277,6293,2984,3261
MS,28159,Winston,-590,9758,4557,5147
MS,28157,Wilkinson,1665,4238,2940,1275
MS,28155,Webster,-2597,4820,1087,3684
MS,28153,Wayne,-1964,10269,4116,6080
MS,28151,Washington,7318,17137,12188,4870
MS,28149,Warren,509,19429,9899,9390
MS,28147,Walthall,-626,7476,3386,4012
MS,28145,Union,-5278,10359,2481,7759
MS,28143,Tunica,2504,4262,3371,867
MS,28141,Tishomingo,-4447,7850,1623,6070
MS,28139,Tippah,-4371,9008,2254,6625
MS,28137,Tate,-2094,11374,4572,6666
MS,28135,Tallahatchie,1358,6363,3838,2480
MS,28133,Sunflower,5082,10995,7989,2907
MS,28131,Stone,-3130,6820,1794,4924
MS,28129,Smith,-4070,8099,1979,6049
MS,28127,Simpson,-2701,12249,4723,7424
MS,28125,Sharkey,896,2258,1571,675
MS,28123,Scott,-954,10584,4774,5728
MS,28121,Rankin,-31893,61438,14425,46318
MS,28119,Quitman,1721,3979,2837,1116
MS,28117,Prentiss,-4258,10033,2817,7075
MS,28115,Pontotoc,-6618,12348,2785,9403
MS,28113,Pike,1318,17429,9304,7986
MS,28111,Perry,-2591,5686,1519,4110
MS,28109,Pearl River,-12023,19938,3813,15836
MS,28107,Panola,1450,16826,9079,7629
MS,28105,Oktibbeha,302,16001,8030,7728
MS,28103,Noxubee,3595,6264,4920,1325
MS,28101,Newton,-2840,9039,3069,5909
MS,28099,Neshoba,-4742,10890,3030,7772
MS,28097,Montgomery,-298,4807,2245,2543
MS,28095,Monroe,-2671,16789,6990,9661
MS,28093,Marshall,3137,16141,9581,6444
MS,28091,Marion,-3285,11041,3833,7118
MS,28089,Madison,-7785,49571,20722,28507
MS,28087,Lowndes,-362,24674,12037,12399
MS,28085,Lincoln,-4454,14303,4879,9333
MS,28083,Leflore,5308,11600,8423,3115
MS,28081,Lee,-9961,34363,12043,22004
MS,28079,Leake,-684,7921,3599,4283
MS,28077,Lawrence,-1759,6584,2394,4153
MS,28075,Lauderdale,-4680,30213,12642,17322
MS,28073,Lamar,-12435,22780,5037,17472
MS,28071,Lafayette,-2674,17191,7098,9772
MS,28069,Kemper,1450,5052,3239,1789
MS,28067,Jones,-11489,30038,9146,20635
MS,28065,Jeff Davis,1655,6618,4094,2439
MS,28063,Jefferson,3077,3953,3508,431
MS,28061,Jasper,904,9340,5097,4193
MS,28059,Jackson,-17810,49290,15452,33262
MS,28057,Itawamba,-5326,8729,1599,6925
MS,28055,Issaquena,177,787,479,302
MS,28053,Humphreys,2330,4481,3399,1069
MS,28051,Holmes,5511,8076,6775,1264
MS,28049,Hinds,44062,97639,70512,26450
MS,28047,Harrison,-16404,61602,22242,38646
MS,28045,Hancock,-8980,17023,3879,12859
MS,28043,Grenada,-701,11320,5279,5980
MS,28041,Greene,-3203,5919,1325,4528
MS,28039,George,-7001,9826,1352,8353
MS,28037,Franklin,-999,4443,1706,2705
MS,28035,Forrest,-3260,27789,12079,15339
MS,28033,DeSoto,-21420,64026,20979,42399
MS,28031,Covington,-1482,9145,3800,5282
MS,28029,Copiah,1487,13002,7201,5714
MS,28027,Coahoma,4808,9563,7164,2356
MS,28025,Clay,2125,9659,5860,3735
MS,28023,Clarke,-1720,7199,2695,4415
MS,28021,Claiborne,4025,5258,4633,608
MS,28019,Choctaw,-1250,3847,1283,2533
MS,28017,Chickasaw,313,7641,3914,3601
MS,28015,Carroll,-1963,5968,1990,3953
MS,28013,Calhoun,-1711,6273,2250,3961
MS,28011,Bolivar,5426,14258,9772,4346
MS,28009,Benton,-4,4080,2026,2030
MS,28007,Attala,-1084,7853,3368,4452
MS,28005,Amite,-1175,7661,3218,4393
MS,28003,Alcorn,-7578,14682,3449,11027
MS,28001,Adams,2457,13621,7999,5542
MN,27173,Yellow Medicine,-341,5397,2465,2806
MN,27171,Wright,-14876,69550,26584,41460
MN,27169,Winona,3500,27103,14980,11480
MN,27167,Wilkin,-626,3212,1258,1884
MN,27165,Watonwan,-23,5115,2494,2517
MN,27163,Washington,1066,141711,70203,69137
MN,27161,Waseca,-746,9706,4370,5116
MN,27159,Wadena,-1651,6772,2492,4143
MN,27157,Wabasha,-634,11722,5415,6049
MN,27155,Traverse,82,1840,942,860
MN,27153,Todd,-1900,11762,4819,6719
MN,27151,Swift,503,5087,2751,2248
MN,27149,Stevens,-24,5621,2742,2766
MN,27147,Steele,-1197,19034,8706,9903
MN,27145,Stearns,-9463,78178,33552,43015
MN,27143,Sibley,-1777,7785,2916,4693
MN,27141,Sherburne,-10251,46320,17597,27848
MN,27139,Scott,-10607,71411,29714,40321
MN,27137,St. Louis,34502,116460,74177,39675
MN,27135,Roseau,-1637,7330,2772,4409
MN,27133,Rock,-865,4830,1945,2810
MN,27131,Rice,2674,32160,17054,14380
MN,27129,Renville,-755,7684,3394,4149
MN,27127,Redwood,-1562,7761,3008,4570
MN,27125,Red Lake,-50,1963,928,978
MN,27123,Ramsey,98137,277782,184936,86799
MN,27121,Pope,-161,6224,2981,3142
MN,27119,Polk,-842,14644,6773,7615
MN,27117,Pipestone,-1100,4637,1728,2828
MN,27115,Pine,-95,13904,6750,6845
MN,27113,Pennington,-280,6493,3024,3304
MN,27111,Otter Tail,-6695,31562,12165,18860
MN,27109,Olmsted,2506,77951,39338,36832
MN,27107,Norman,346,3199,1730,1384
MN,27105,Nobles,-788,8493,3793,4581
MN,27103,Nicollet,1438,18285,9652,8214
MN,27101,Murray,-344,4754,2160,2504
MN,27099,Mower,4191,18471,11129,6938
MN,27097,Morrison,-4006,16662,6153,10159
MN,27095,Mille Lacs,-1122,13047,5829,6951
MN,27093,Meeker,-1944,12167,4969,6913
MN,27091,Martin,-2603,10927,4054,6657
MN,27089,Marshall,-526,4335,1854,2380
MN,27087,Mahnomen,405,2179,1276,871
MN,27085,McLeod,-4099,18455,6970,11069
MN,27083,Lyon,-1130,12334,5465,6595
MN,27081,Lincoln,-166,3113,1428,1594
MN,27079,Le Sueur,-961,14730,6753,7714
MN,27077,Lake of the Woods,-447,2220,859,1306
MN,27075,Lake,1433,6797,4043,2610
MN,27073,Lac Qui Parle,36,3974,1974,1938
MN,27071,Koochiching,610,6432,3451,2841
MN,27069,Kittson,146,2405,1241,1095
MN,27067,Kandiyohi,-1433,21403,9806,11239
MN,27065,Kanabec,-733,8107,3586,4319
MN,27063,Jackson,-776,5415,2268,3044
MN,27061,Itasca,2352,23833,12852,10500
MN,27059,Isanti,-3651,20131,8024,11675
MN,27057,Hubbard,-1946,11482,4676,6622
MN,27055,Houston,330,10422,5281,4951
MN,27053,Hennepin,183906,677965,423979,240073
MN,27051,Grant,-101,3471,1647,1748
MN,27049,Goodhue,-774,25701,12212,12986
MN,27047,Freeborn,2357,16645,9327,6970
MN,27045,Fillmore,800,10854,5713,4913
MN,27043,Faribault,-697,7689,3407,4104
MN,27041,Douglas,-3240,20917,8665,11905
MN,27039,Dodge,-1035,10272,4487,5522
MN,27037,Dakota,6738,230023,116252,109514
MN,27035,Crow Wing,-4655,34800,14760,19415
MN,27033,Cottonwood,-883,5848,2433,3316
MN,27031,Cook,772,3304,1993,1221
MN,27029,Clearwater,-606,4183,1753,2359
MN,27027,Clay,2290,28771,15210,12920
MN,27025,Chisago,-3703,29331,12524,16227
MN,27023,Chippewa,116,6176,3083,2967
MN,27021,Cass,-2099,16080,6858,8957
MN,27019,Carver,-10410,52747,20745,31155
MN,27017,Carlton,4803,18356,11389,6586
MN,27015,Brown,-2308,13882,5630,7938
MN,27013,Blue Earth,3248,34039,18164,14916
MN,27011,Big Stone,-40,2783,1345,1385
MN,27009,Benton,-2676,19521,8173,10849
MN,27007,Beltrami,2181,21949,11818,9637
MN,27005,Becker,-2375,16329,6829,9204
MN,27003,Anoka,-4819,185714,88611,93430
MN,27001,Aitkin,-121,9109,4412,4533
MI,26165,Wexford,-2255,13859,5717,7972
MI,26163,Wayne,381667,814108,595253,213586
MI,26161,Washtenaw,64390,179016,120791,56401
MI,26159,Van Buren,148,32798,16288,16140
MI,26157,Tuscola,-2874,26482,11643,14517
MI,26155,Shiawassee,1235,33590,17197,15962
MI,26153,Schoolcraft,-277,4046,1865,2142
MI,26151,Sanilac,-3749,18359,7212,10961
MI,26149,St. Joseph,-2869,23314,10106,12975
MI,26147,St. Clair,-5231,73740,33845,39076
MI,26145,Saginaw,11656,97903,54372,42716
MI,26143,Roscommon,-503,13032,6198,6701
MI,26141,Presque Isle,-602,7077,3192,3794
MI,26139,Ottawa,-45435,132695,43068,88503
MI,26137,Otsego,-2327,11829,4681,7008
MI,26135,Oscoda,-654,4027,1654,2308
MI,26133,Osceola,-2159,10265,3981,6140
MI,26131,Ontonagon,-321,3535,1585,1906
MI,26129,Ogemaw,-646,10361,4791,5437
MI,26127,Oceana,-1176,11438,5063,6239
MI,26125,Oakland,52524,650306,349055,296531
MI,26123,Newaygo,-3735,21424,8723,12458
MI,26121,Muskegon,13554,76054,44436,30882
MI,26119,Montmorency,-879,5051,2049,2928
MI,26117,Montcalm,-2193,25383,11431,13624
MI,26115,Monroe,717,72682,36310,35593
MI,26113,Missaukee,-2391,7024,2274,4665
MI,26111,Midland,-6462,41808,17480,23942
MI,26109,Menominee,-321,10922,5244,5565
MI,26107,Mecosta,-1660,16879,7515,9175
MI,26105,Mason,-724,14588,6856,7580
MI,26103,Marquette,4517,32144,18126,13609
MI,26101,Manistee,731,12385,6467,5736
MI,26099,Macomb,16096,403388,207992,191896
MI,26097,Mackinac,-744,6097,2652,3396
MI,26095,Luce,-550,2477,951,1501
MI,26093,Livingston,-22814,97959,37186,60000
MI,26091,Lenawee,-577,44619,21774,22351
MI,26089,Leelanau,-907,14164,6576,7483
MI,26087,Lapeer,-4939,43025,18786,23725
MI,26085,Lake,265,5287,2752,2487
MI,26083,Keweenaw,-192,1388,582,774
MI,26081,Kent,-23241,295418,134560,157801
MI,26079,Kalkaska,-1629,8281,3268,4897
MI,26077,Kalamazoo,16385,122880,69045,52660
MI,26075,Jackson,-3997,69323,32301,36298
MI,26073,Isabella,2238,24119,13038,10800
MI,26071,Iron,-537,5987,2687,3224
MI,26069,Iosco,-664,13330,6242,6906
MI,26067,Ionia,-3303,25730,11016,14319
MI,26065,Ingham,35538,127579,80903,45365
MI,26063,Huron,-2254,15274,6432,8686
MI,26061,Houghton,-1510,14804,6530,8040
MI,26059,Hillsdale,-4621,19081,7106,11727
MI,26057,Gratiot,-630,16011,7606,8236
MI,26055,Grand Traverse,-5657,47901,20875,26532
MI,26053,Gogebic,614,7576,4058,3444
MI,26051,Gladwin,-901,12552,5760,6661
MI,26049,Genesee,57165,202699,128972,71807
MI,26047,Emmet,-3028,17672,7225,10253
MI,26045,Eaton,1719,54707,27912,26193
MI,26043,Dickinson,-2736,12785,4952,7688
MI,26041,Delta,-1203,18043,8330,9533
MI,26039,Crawford,-750,6814,2994,3744
MI,26037,Clinton,-2443,39125,18187,20630
MI,26035,Clare,-651,13492,6337,6988
MI,26033,Chippewa,-1178,15564,7100,8278
MI,26031,Cheboygan,-1455,13288,5829,7284
MI,26029,Charlevoix,-2061,14064,5936,7997
MI,26027,Cass,-3073,22461,9587,12660
MI,26025,Calhoun,932,58231,29270,28338
MI,26023,Branch,-3049,16278,6526,9575
MI,26021,Berrien,-4744,72322,33465,38209
MI,26019,Benzie,-388,9847,4683,5071
MI,26017,Bay,3062,51077,26797,23735
MI,26015,Barry,-5155,28483,11496,16651
MI,26013,Baraga,-292,3490,1574,1866
MI,26011,Arenac,-385,7826,3669,4054
MI,26009,Antrim,-2810,13184,5107,7917
MI,26007,Alpena,-749,14014,6549,7298
MI,26005,Allegan,-9429,49199,19594,29023
MI,26003,Alger,-117,4603,2212,2329
MI,26001,Alcona,-1109,6086,2462,3571
MA,25027,Ashburnham,92,3212,1621,1529
MA,25027,Athol,455,4712,2525,2070
MA,25027,Auburn,379,8778,4495,4116
MA,25027,Barre,64,2683,1343,1279
MA,25027,Berlin,87,1803,917,830
MA,25027,Blackstone,194,4315,2221,2027
MA,25027,Bolton,80,3046,1537,1457
MA,25027,Boylston,-57,2678,1284,1341
MA,25027,Brookfield,-31,1720,822,853
MA,25027,Charlton,-750,6706,2910,3660
MA,25027,Clinton,1041,6064,3492,2451
MA,25027,Douglas,-648,4509,1894,2542
MA,25027,Dudley,-78,5067,2466,2544
MA,25027,East Brookfield,-193,1146,469,662
MA,25027,Fitchburg,2930,14364,8504,5574
MA,25027,Gardner,1364,8192,4687,3323
MA,25027,Grafton,426,9450,4853,4427
MA,25027,Hardwick,151,1309,710,559
MA,25027,Harvard,804,3603,2166,1362
MA,25027,Holden,-239,10503,5055,5294
MA,25027,Hopedale,171,3282,1698,1527
MA,25027,Hubbardston,-221,2600,1160,1381
MA,25027,Lancaster,-190,3710,1724,1914
MA,25027,Leicester,77,5507,2744,2667
MA,25027,Leominster,1229,18606,9769,8540
MA,25027,Lunenburg,-290,5895,2748,3038
MA,25027,Mendon,-323,3406,1517,1840
MA,25027,Milford,1625,12814,7129,5504
MA,25027,Millbury,148,6784,3410,3262
MA,25027,Millville,-96,1557,717,813
MA,25027,New Braintree,26,559,283,257
MA,25027,Northborough,515,8394,4387,3872
MA,25027,Northbridge,-664,7607,3408,4072
MA,25027,North Brookfield,-221,2367,1050,1271
MA,25027,Oakham,-100,1146,509,609
MA,25027,Oxford,-136,6494,3125,3261
MA,25027,Paxton,-235,2502,1119,1354
MA,25027,Petersham,113,814,451,338
MA,25027,Phillipston,-5,951,464,469
MA,25027,Princeton,-36,2302,1112,1148
MA,25027,Royalston,124,676,391,267
MA,25027,Rutland,-258,4471,2071,2329
MA,25027,Shrewsbury,1520,18054,9674,8154
MA,25027,Southborough,153,5804,2935,2782
MA,25027,Southbridge,1965,6604,4256,2291
MA,25027,Spencer,-168,5530,2617,2785
MA,25027,Sterling,-638,4775,2029,2667
MA,25027,Sturbridge,-101,5245,2514,2615
MA,25027,Sutton,-906,5357,2181,3087
MA,25027,Templeton,6,3777,1857,1851
MA,25027,Upton,-147,4196,1985,2132
MA,25027,Uxbridge,-403,7181,3325,3728
MA,25027,Warren,217,2303,1219,1002
MA,25027,Webster,365,6706,3476,3111
MA,25027,Westborough,1181,8952,4999,3818
MA,25027,West Boylston,-54,4167,2029,2083
MA,25027,West Brookfield,14,1946,964,950
MA,25027,Westminster,-305,4276,1940,2245
MA,25027,Winchendon,209,4160,2142,1933
MA,25027,Worcester,23413,58756,40568,17155
MA,25025,Boston,147869,248482,196096,48227
MA,25025,Chelsea,5250,8375,6760,1510
MA,25025,Revere,5581,16897,11141,5560
MA,25025,Winthrop,1636,8895,5211,3575
MA,25023,Abington,53,8244,4104,4051
MA,25023,Bridgewater,-315,12020,5774,6089
MA,25023,Brockton,16472,34118,25140,8668
MA,25023,Carver,-237,6046,2870,3107
MA,25023,Duxbury,-1081,9662,4244,5325
MA,25023,East Bridgewater,-527,7298,3340,3867
MA,25023,Halifax,-1068,3108,997,2065
MA,25023,Hanover,-1568,8323,3342,4910
MA,25023,Hanson,-487,5568,2512,2999
MA,25023,Hingham,-481,14116,6750,7231
MA,25023,Hull,1159,6068,3576,2417
MA,25023,Kingston,-548,6965,3176,3724
MA,25023,Lakeville,-890,5784,2411,3301
MA,25023,Marion,269,3226,1725,1456
MA,25023,Marshfield,-825,15071,7041,7866
MA,25023,Mattapoisett,186,3953,2041,1855
MA,25023,Middleborough,-837,11410,5192,6029
MA,25023,Norwell,-970,6460,2714,3684
MA,25023,Pembroke,-499,9759,4574,5073
MA,25023,Plymouth,848,29736,15106,14258
MA,25023,Plympton,-152,1738,776,928
MA,25023,Rochester,-342,3125,1362,1704
MA,25023,Rockland,537,8640,4526,3989
MA,25023,Scituate,-131,11321,5528,5659
MA,25023,Wareham,1437,10856,6069,4632
MA,25023,West Bridgewater,-435,3955,1734,2169
MA,25023,Whitman,2,7423,3654,3652
MA,25021,Avon,90,2394,1221,1131
MA,25021,Bellingham,3137,5515,4256,1119
MA,25021,Braintree,798,19461,10015,9217
MA,25021,Brookline,16044,27935,21761,5717
MA,25021,Canton,678,12319,6430,5752
MA,25021,Cohasset,-369,4863,2226,2595
MA,25021,Dedham,1999,13611,7718,5719
MA,25021,Dover,-473,3574,1531,2004
MA,25021,Foxborough,-53,9663,4745,4798
MA,25021,Franklin,40,17401,8589,8549
MA,25021,Holbrook,622,5498,3024,2402
MA,25021,Medfield,-416,7415,3448,3864
MA,25021,Medway,96,7232,3615,3519
MA,25021,Millis,189,4736,2421,2232
MA,25021,Milton,3377,15803,9499,6122
MA,25021,Needham,3694,16903,10207,6513
MA,25021,Norfolk,-775,5698,2424,3199
MA,25021,Norwood,1806,14596,8098,6292
MA,25021,Plainville,-201,4396,2068,2269
MA,25021,Quincy,9898,40156,24714,14816
MA,25021,Randolph,7880,15113,11430,3550
MA,25021,Sharon,2899,10338,6558,3659
MA,25021,Stoughton,2528,13890,8119,5591
MA,25021,Walpole,-1096,13984,6360,7456
MA,25021,Wellesley,2099,14549,8243,6144
MA,25021,Westwood,-212,8992,4337,4549
MA,25021,Weymouth,2789,27832,15130,12341
MA,25021,Wrentham,-831,6328,2704,3535
MA,25019,Nantucket,1643,6097,3828,2185
MA,25017,Acton,3928,11848,7779,3851
MA,25017,Arlington,11921,25799,18580,6659
MA,25017,Ashby,-134,1830,827,961
MA,25017,Ashland,1547,8512,4954,3407
MA,25017,Ayer,466,3644,2023,1557
MA,25017,Bedford,1390,7628,4436,3046
MA,25017,Belmont,4380,14077,9108,4728
MA,25017,Billerica,-151,19998,9774,9925
MA,25017,Boxborough,603,2928,1737,1134
MA,25017,Burlington,784,13318,6971,6187
MA,25017,Cambridge,36651,48787,41991,5340
MA,25017,Carlisle,641,3348,1959,1318
MA,25017,Chelmsford,72,19459,9606,9534
MA,25017,Concord,3773,10960,7282,3509
MA,25017,Dracut,-1101,15175,6925,8026
MA,25017,Dunstable,-215,1889,819,1034
MA,25017,Everett,5810,13110,9392,3582
MA,25017,Framingham,9402,27704,18340,8938
MA,25017,Groton,395,6113,3201,2806
MA,25017,Holliston,1119,8267,4621,3502
MA,25017,Hopkinton,-137,8654,4197,4334
MA,25017,Hudson,1459,10012,5642,4183
MA,25017,Lexington,7388,18257,12675,5287
MA,25017,Lincoln,1503,3660,2558,1055
MA,25017,Littleton,558,5382,2915,2357
MA,25017,Lowell,12011,33778,22597,10586
MA,25017,Malden,9226,20968,14940,5714
MA,25017,Marlborough,2709,16706,9576,6867
MA,25017,Maynard,1612,5788,3635,2023
MA,25017,Medford,10319,27401,18613,8294
MA,25017,Melrose,3353,15427,9289,5936
MA,25017,Natick,4843,18642,11600,6757
MA,25017,Newton,19945,44963,32099,12154
MA,25017,North Reading,-655,8741,3986,4641
MA,25017,Pepperell,-490,6482,2936,3426
MA,25017,Reading,807,14257,7447,6640
MA,25017,Sherborn,251,2653,1430,1179
MA,25017,Shirley,71,3130,1553,1482
MA,25017,Somerville,23602,34622,28467,4865
MA,25017,Stoneham,1054,12368,6634,5580
MA,25017,Stow,517,4256,2348,1831
MA,25017,Sudbury,1685,10482,6026,4341
MA,25017,Tewksbury,-792,16081,7540,8332
MA,25017,Townsend,-638,4923,2087,2725
MA,25017,Tyngsborough,-524,6293,2837,3361
MA,25017,Wakefield,680,14478,7486,6806
MA,25017,Waltham,6932,25066,15748,8816
MA,25017,Watertown,7362,16716,11878,4516
MA,25017,Wayland,2178,8260,5153,2975
MA,25017,Westford,90,12896,6385,6295
MA,25017,Weston,231,6621,3390,3159
MA,25017,Wilmington,-547,12489,5890,6437
MA,25017,Winchester,1398,12767,7000,5602
MA,25017,Woburn,1584,19243,10291,8707
MA,25015,Amherst,10444,14883,12316,1872
MA,25015,Belchertown,1656,7587,4542,2886
MA,25015,Chesterfield,227,716,455,228
MA,25015,Cummington,229,528,368,139
MA,25015,Easthampton,3818,9002,6281,2463
MA,25015,Goshen,197,614,395,198
MA,25015,Granby,292,3486,1862,1570
MA,25015,Hadley,1233,3071,2119,886
MA,25015,Hatfield,724,2035,1362,638
MA,25015,Huntington,75,1099,554,479
MA,25015,Middlefield,125,291,202,77
MA,25015,Northampton,10931,15915,13110,2179
MA,25015,Pelham,596,887,728,132
MA,25015,Plainfield,203,385,286,83
MA,25015,Southampton,277,3494,1861,1584
MA,25015,South Hadley,2110,8761,5362,3252
MA,25015,Ware,607,4249,2390,1783
MA,25015,Westhampton,254,1058,639,385
MA,25015,Williamsburg,915,1622,1239,324
MA,25015,Worthington,273,723,481,208
MA,25013,Agawam,418,14354,7288,6870
MA,25013,Blandford,-48,660,300,348
MA,25013,Brimfield,-197,2042,897,1094
MA,25013,Chester,26,661,331,305
MA,25013,Chicopee,6055,22923,14292,8237
MA,25013,East Longmeadow,-438,8704,4085,4523
MA,25013,Granville,-128,890,374,502
MA,25013,Hampden,-283,2905,1286,1569
MA,25013,Holland,-97,1324,593,690
MA,25013,Holyoke,8853,16388,12492,3639
MA,25013,Longmeadow,1189,8614,4851,3662
MA,25013,Ludlow,938,9671,5233,4295
MA,25013,Monson,144,4291,2176,2032
MA,25013,Montgomery,-54,507,220,274
MA,25013,Palmer,538,5636,3020,2482
MA,25013,Russell,2,788,388,386
MA,25013,Southwick,-720,4901,2050,2770
MA,25013,Springfield,32591,53908,42963,10372
MA,25013,Tolland,-45,278,110,155
MA,25013,Wales,45,927,479,434
MA,25013,Westfield,1050,17735,9228,8178
MA,25013,West Springfield,1001,11515,6170,5169
MA,25013,Wilbraham,-587,8205,3745,4332
MA,25011,Ashfield,705,1121,892,187
MA,25011,Bernardston,480,1166,809,329
MA,25011,Buckland,498,1034,750,252
MA,25011,Charlemont,290,639,456,166
MA,25011,Colrain,386,881,618,232
MA,25011,Conway,638,1250,926,288
MA,25011,Deerfield,1264,3018,2103,839
MA,25011,Erving,357,770,557,200
MA,25011,Gill,434,887,646,212
MA,25011,Greenfield,4284,8340,6175,1891
MA,25011,Hawley,61,198,126,65
MA,25011,Heath,168,426,292,124
MA,25011,Leverett,804,1220,987,183
MA,25011,Leyden,224,462,339,115
MA,25011,Monroe,11,53,32,21
MA,25011,Montague,2340,4212,3213,873
MA,25011,New Salem,176,606,381,205
MA,25011,Northfield,642,1627,1115,473
MA,25011,Orange,493,3235,1818,1325
MA,25011,Rowe,48,241,140,92
MA,25011,Shelburne,647,1134,873,226
MA,25011,Shutesbury,872,1250,1028,156
MA,25011,Sunderland,959,1862,1363,404
MA,25011,Warwick,225,453,334,109
MA,25011,Wendell,355,555,425,70
MA,25011,Whately,325,960,626,301
MA,25009,Amesbury,1371,8396,4817,3446
MA,25009,Andover,234,18598,9287,9053
MA,25009,Beverly,3771,20635,12075,8304
MA,25009,Boxford,-983,5142,2049,3032
MA,25009,Danvers,360,14507,7344,6984
MA,25009,Essex,192,2158,1154,962
MA,25009,Georgetown,-305,4915,2272,2577
MA,25009,Gloucester,4169,15427,9680,5511
MA,25009,Groveland,-256,3970,1824,2080
MA,25009,Hamilton,-41,4446,2163,2204
MA,25009,Haverhill,3584,27535,15342,11758
MA,25009,Ipswich,675,8295,4417,3742
MA,25009,Lawrence,14781,21884,18240,3459
MA,25009,Lynn,14502,31800,22965,8463
MA,25009,Lynnfield,-1646,7260,2773,4419
MA,25009,Manchester,347,3473,1886,1539
MA,25009,Marblehead,1402,12364,6824,5422
MA,25009,Merrimac,187,3566,1844,1657
MA,25009,Methuen,880,21470,11048,10168
MA,25009,Middleton,-742,4610,1909,2651
MA,25009,Nahant,474,2295,1371,897
MA,25009,Newbury,172,4432,2272,2100
MA,25009,Newburyport,2725,11011,6784,4059
MA,25009,North Andover,-1001,15131,6991,7992
MA,25009,Peabody,3394,26890,15010,11616
MA,25009,Rockport,1312,4744,2982,1670
MA,25009,Rowley,-339,3582,1596,1935
MA,25009,Salem,7794,19435,13429,5635
MA,25009,Salisbury,340,4277,2278,1938
MA,25009,Saugus,400,13656,6957,6557
MA,25009,Swampscott,1697,8206,4899,3202
MA,25009,Topsfield,-364,4010,1800,2164
MA,25009,Wenham,-207,2359,1058,1265
MA,25009,West Newbury,36,2767,1383,1347
MA,25007,Aquinnah,213,297,251,38
MA,25007,Chilmark,458,727,585,127
MA,25007,Edgartown,872,2562,1699,827
MA,25007,Gosnold,13,87,49,36
MA,25007,Oak Bluffs,1160,2781,1955,795
MA,25007,Tisbury,1250,2485,1845,595
MA,25007,West Tisbury,1200,1975,1571,371
MA,25005,Acushnet,838,5289,3021,2183
MA,25005,Attleboro,1963,19128,10369,8406
MA,25005,Berkley,-117,3297,1569,1686
MA,25005,Dartmouth,3853,16024,9817,5964
MA,25005,Dighton,-99,3628,1743,1842
MA,25005,Easton,-472,11989,5690,6162
MA,25005,Fairhaven,1937,8255,5019,3082
MA,25005,Fall River,14401,29467,21724,7323
MA,25005,Freetown,60,4632,2301,2241
MA,25005,Mansfield,55,11948,5910,5855
MA,25005,New Bedford,17664,33220,25205,7541
MA,25005,North Attleborough,-729,14147,6602,7331
MA,25005,Norton,5,9052,4454,4449
MA,25005,Raynham,-440,6967,3217,3657
MA,25005,Rehoboth,-334,6257,2912,3246
MA,25005,Seekonk,390,7269,3772,3382
MA,25005,Somerset,2417,9907,6091,3674
MA,25005,Swansea,1243,7882,4512,3269
MA,25005,Taunton,4696,22620,13479,8783
MA,25005,Westport,1702,8587,5074,3372
MA,25003,Adams,2192,3905,3010,818
MA,25003,Alford,169,304,233,64
MA,25003,Becket,425,967,684,259
MA,25003,Cheshire,723,1741,1216,493
MA,25003,Clarksburg,381,857,613,232
MA,25003,Dalton,1545,3388,2433,888
MA,25003,Egremont,525,840,676,151
MA,25003,Florida,127,389,254,127
MA,25003,Great Barrington,2321,3587,2916,595
MA,25003,Hancock,86,382,228,142
MA,25003,Hinsdale,431,1057,728,297
MA,25003,Lanesborough,714,1596,1144,430
MA,25003,Lee,1437,2912,2150,713
MA,25003,Lenox,1643,3049,2318,675
MA,25003,Monterey,320,529,417,97
MA,25003,Mount Washington,64,108,83,19
MA,25003,New Ashford,67,153,107,40
MA,25003,New Marlborough,332,836,572,240
MA,25003,North Adams,3283,5710,4427,1144
MA,25003,Otis,178,829,489,311
MA,25003,Peru,188,474,324,136
MA,25003,Pittsfield,11556,19988,15600,4044
MA,25003,Richmond,462,923,688,226
MA,25003,Sandisfield,140,455,294,154
MA,25003,Savoy,138,355,241,103
MA,25003,Sheffield,788,1832,1291,503
MA,25003,Stockbridge,718,1208,944,226
MA,25003,Tyringham,88,258,173,85
MA,25003,Washington,170,315,239,69
MA,25003,West Stockbridge,546,886,707,161
MA,25003,Williamstown,2372,3723,3012,640
MA,25003,Windsor,258,522,385,127
MA,25001,Barnstable,552,25437,12842,12290
MA,25001,Bourne,-533,10077,4719,5252
MA,25001,Brewster,921,6517,3669,2748
MA,25001,Chatham,9,4614,2287,2278
MA,25001,Dennis,648,9245,4892,4244
MA,25001,Eastham,741,3678,2187,1446
MA,25001,Falmouth,2883,19404,11013,8130
MA,25001,Harwich,769,8099,4376,3607
MA,25001,Mashpee,75,8280,4133,4058
MA,25001,Orleans,574,4467,2496,1922
MA,25001,Provincetown,1911,2380,2121,210
MA,25001,Sandwich,-690,12433,5802,6492
MA,25001,Truro,642,1467,1041,399
MA,25001,Wellfleet,949,2242,1568,619
MA,25001,Yarmouth,657,13872,7183,6526
MD,24510,Baltimore City,175541,229897,201042,25501
MD,24047,Worcester,-4493,24526,9841,14334
MD,24045,Wicomico,-2655,38256,17481,20136
MD,24043,Washington,-10831,58653,23282,34113
MD,24041,Talbot,-2459,18671,7983,10442
MD,24039,Somerset,-228,9272,4478,4706
MD,24037,St. Mary's,-7114,44076,17982,25096
MD,24035,Queen Anne's,-6981,23153,7898,14879
MD,24033,Prince George's,285106,352292,317342,32236
MD,24031,Montgomery,175553,404214,286493,110940
MD,24029,Kent,-80,9143,4453,4533
MD,24027,Howard,29923,141167,84017,54094
MD,24025,Harford,-23106,118417,46390,69496
MD,24023,Garrett,-6310,12113,2792,9102
MD,24021,Frederick,-4308,109127,51187,55495
MD,24019,Dorchester,-944,14249,6570,7514
MD,24017,Charles,21984,70167,45621,23637
MD,24015,Cecil,-8171,40037,15489,23660
MD,24013,Carroll,-27893,82171,26067,53960
MD,24011,Caroline,-3053,12526,4621,7674
MD,24009,Calvert,-3450,42168,18963,22413
MD,24005,Baltimore,58047,354655,202733,144686
MD,24003,Anne Arundel,-2205,239189,115960,118165
MD,24001,Allegany,-9157,27817,9001,18158
ME,23031,Acton,63,1340,688,625
ME,23031,Alfred,225,1739,964,739
ME,23031,Arundel,269,2248,1229,960
ME,23031,Berwick,-79,3629,1733,1812
ME,23031,Biddeford,3571,9884,6618,3047
ME,23031,Buxton,303,4218,2212,1909
ME,23031,Cornish,91,756,415,324
ME,23031,Dayton,87,1127,590,503
ME,23031,Eliot,566,3925,2210,1644
ME,23031,Hollis,195,2381,1249,1054
ME,23031,Kennebunk,1137,6851,3935,2798
ME,23031,Kennebunkport,250,2425,1323,1073
ME,23031,Kittery,1629,5365,3443,1814
ME,23031,Lebanon,-236,2911,1286,1522
ME,23031,Limerick,91,1432,737,646
ME,23031,Limington,31,1843,908,877
ME,23031,Lyman,264,2347,1270,1006
ME,23031,Newfield,40,792,406,366
ME,23031,North Berwick,95,2683,1361,1266
ME,23031,Ogunquit,202,910,549,347
ME,23031,Old Orchrd Bch,1443,5142,3247,1804
ME,23031,Parsonsfield,91,864,471,380
ME,23031,Saco,2590,9891,6146,3556
ME,23031,Sanford,1887,9504,5588,3701
ME,23031,Shapleigh,27,1446,720,693
ME,23031,South Berwick,650,3992,2276,1626
ME,23031,Waterboro,267,3519,1848,1581
ME,23031,Wells,570,5894,3182,2612
ME,23031,York,1294,8569,4888,3594
ME,23029,Addison,-26,585,273,299
ME,23029,Alexander,-22,288,131,153
ME,23029,Baileyville,124,623,354,230
ME,23029,Baring Plt.,7,106,56,49
ME,23029,Beals,-3,277,134,137
ME,23029,Beddington,-8,35,13,21
ME,23029,Calais,5,1486,730,725
ME,23029,Charlotte,-33,169,64,97
ME,23029,Cherryfield,-25,592,278,303
ME,23029,Columbia,-59,201,67,126
ME,23029,Columbia Falls,-26,283,122,148
ME,23029,Cooper,-10,129,57,67
ME,23029,Crawford,-17,63,23,40
ME,23029,Cutler,-47,284,116,163
ME,23029,Danforth,-40,265,110,150
ME,23029,Deblois,-13,27,7,20
ME,23029,Dennysville,0,157,77,77
ME,23029,East Machias,-71,707,310,381
ME,23029,Eastport,192,838,488,296
ME,23029,Grand Lake Stream Plt,-16,100,42,58
ME,23029,Harrington,-83,454,181,264
ME,23029,Indian Township Vtng Dst,183,236,208,25
ME,23029,Jonesboro,-6,292,140,146
ME,23029,Jonesport,15,616,311,296
ME,23029,Lubec,158,789,465,307
ME,23029,Machias,53,868,449,396
ME,23029,Machiasport,3,489,243,240
ME,23029,Marshfield,-44,289,119,163
ME,23029,Meddybemps,-14,89,36,50
ME,23029,Milbridge,38,611,320,282
ME,23029,Northfield,0,95,47,47
ME,23029,Pembroke,18,452,229,211
ME,23029,Perry,2,448,219,217
ME,23029,Pleasant Point Votng Dst,175,238,204,29
ME,23029,Princeton,-55,462,196,251
ME,23029,Robbinston,1,293,143,142
ME,23029,Roque Bluffs,32,154,92,60
ME,23029,Steuben,-12,545,257,269
ME,23029,Talmadge,-6,32,13,19
ME,23029,Topsfield,-35,113,38,73
ME,23029,Vanceboro,-1,105,51,52
ME,23029,Waite,-11,58,22,33
ME,23029,Washington Cty Townships,-69,289,104,173
ME,23029,Wesley,-12,77,32,44
ME,23029,Whiting,24,338,178,154
ME,23029,Whitneyville,-8,109,48,56
ME,23027,Belfast,1030,3603,2270,1240
ME,23027,Belmont,47,489,261,214
ME,23027,Brooks,-17,513,243,260
ME,23027,Burnham,-2,595,290,292
ME,23027,Frankfort,-28,529,242,270
ME,23027,Freedom,52,392,215,163
ME,23027,Islesboro,148,418,282,134
ME,23027,Jackson,-10,279,127,137
ME,23027,Knox,-68,395,158,226
ME,23027,Liberty,40,492,259,219
ME,23027,Lincolnville,323,1427,858,535
ME,23027,Monroe,73,482,265,192
ME,23027,Montville,127,541,319,192
ME,23027,Morrill,-54,500,217,271
ME,23027,Northport,137,950,535,398
ME,23027,Palermo,-77,800,352,429
ME,23027,Prospect,43,354,193,150
ME,23027,Searsmont,50,733,383,333
ME,23027,Searsport,145,1431,767,622
ME,23027,Stockton Springs,67,946,491,424
ME,23027,Swanville,67,704,362,295
ME,23027,Thorndike,60,383,214,154
ME,23027,Troy,-2,526,258,260
ME,23027,Unity,36,975,479,443
ME,23027,Waldo,41,423,225,184
ME,23027,Winterport,9,2096,1027,1018
ME,23025,Anson,31,1086,543,512
ME,23025,Athens,7,430,211,204
ME,23025,Bingham,45,461,248,203
ME,23025,Brighton Plt.,-4,43,19,23
ME,23025,Cambridge,-69,267,96,165
ME,23025,Canaan,51,1005,515,464
ME,23025,Caratunk,-5,51,23,28
ME,23025,Cornville,-54,672,304,358
ME,23025,Dennistown Plt.,-4,15,5,9
ME,23025,Detroit,16,394,201,185
ME,23025,Embden,-30,483,218,248
ME,23025,Fairfield,355,3185,1714,1359
ME,23025,Harmony,-49,450,196,245
ME,23025,Hartland,-163,839,324,487
ME,23025,Highland Plt.,-23,106,39,62
ME,23025,Jackman,-101,504,190,291
ME,23025,Madison,194,2096,1118,924
ME,23025,Mercer,26,363,190,164
ME,23025,Moose River,-43,111,33,76
ME,23025,Moscow,27,249,137,110
ME,23025,New Portland,19,423,213,194
ME,23025,Norridgewock,-34,1630,772,806
ME,23025,Palmyra,-146,1038,430,576
ME,23025,Pittsfield,-72,1845,869,941
ME,23025,Pleasant Ridge Plt.,7,51,29,22
ME,23025,Ripley,-37,231,93,130
ME,23025,St. Albans,-204,1056,416,620
ME,23025,Skowhegan,667,3899,2225,1558
ME,23025,Smithfield,10,568,282,272
ME,23025,Solon,2,550,268,266
ME,23025,Somerset Cty Townships,-50,196,71,121
ME,23025,Starks,38,317,171,133
ME,23025,The Forks Plt.,2,44,23,21
ME,23025,West Forks Plt.,4,47,25,21
ME,23023,Arrowsic,128,321,220,92
ME,23023,Bath,1383,4528,2895,1512
ME,23023,Bowdoin,-126,1590,711,837
ME,23023,Bowdoinham,329,1752,1020,691
ME,23023,Georgetown,174,733,447,273
ME,23023,Phippsburg,147,1390,754,607
ME,23023,Richmond,180,1771,952,772
ME,23023,Topsham,894,5526,3153,2259
ME,23023,West Bath,97,1211,641,544
ME,23023,Woolwich,186,1912,1028,842
ME,23021,Abbot,-63,379,153,216
ME,23021,Atkinson,-30,179,73,103
ME,23021,Beaver Cove,-11,94,41,52
ME,23021,Bowerbank,-12,84,36,48
ME,23021,Brownville,1,711,346,345
ME,23021,Dover-Foxcroft,-67,2106,991,1058
ME,23021,Greenville,94,1120,599,505
ME,23021,Guilford,-58,687,299,357
ME,23021,Kingsbury Plt.,3,19,11,8
ME,23021,Lake View Plt.,15,63,39,24
ME,23021,Medford,-32,134,48,80
ME,23021,Milo,-66,1118,506,572
ME,23021,Monson,-5,441,208,213
ME,23021,Parkman,-51,416,176,227
ME,23021,Piscataquis Cty Townshps,-19,58,19,38
ME,23021,Sangerville,-24,667,317,341
ME,23021,Sebec,-86,374,139,225
ME,23021,Shirley,-22,135,55,77
ME,23021,Wellington,40,124,80,40
ME,23021,Willimantic,-16,81,32,48
ME,23019,Alton,14,448,225,211
ME,23019,Bangor,2904,15083,8809,5905
ME,23019,Bradford,-98,611,251,349
ME,23019,Bradley,94,797,439,345
ME,23019,Brewer,-92,5081,2450,2542
ME,23019,Burlington,-46,189,69,115
ME,23019,Carmel,-271,1453,578,849
ME,23019,Carroll Plt.,-23,83,29,52
ME,23019,Charleston,-268,655,186,454
ME,23019,Chester,-88,323,114,202
ME,23019,Clifton,-10,462,221,231
ME,23019,Corinna,-234,1089,414,648
ME,23019,Corinth,-397,1380,477,874
ME,23019,Dexter,-115,1643,745,860
ME,23019,Dixmont,-34,693,323,357
ME,23019,Drew Plt.,-6,20,7,13
ME,23019,East Millinocket,67,920,483,416
ME,23019,Eddington,-125,1264,557,682
ME,23019,Edinburg,10,94,52,42
ME,23019,Enfield,-33,769,356,389
ME,23019,Etna,-88,615,256,344
ME,23019,Exeter,-92,542,220,312
ME,23019,Garland,-41,547,246,287
ME,23019,Glenburn,-145,2455,1136,1281
ME,23019,Greenbush,-89,610,253,342
ME,23019,Hampden,-86,4180,2013,2099
ME,23019,Hermon,-481,3025,1250,1731
ME,23019,Holden,-232,1927,827,1059
ME,23019,Howland,53,647,342,289
ME,23019,Hudson,-166,732,278,444
ME,23019,Kenduskeag,-14,629,302,316
ME,23019,LaGrange,-39,322,139,178
ME,23019,Lakeville,-4,80,37,41
ME,23019,Lee,-131,453,160,291
ME,23019,Levant,-337,1459,538,875
ME,23019,Lincoln,-361,2381,977,1338
ME,23019,Lowell,-48,193,71,119
ME,23019,Mattawamkeag,5,357,176,171
ME,23019,Maxfield,-10,54,22,32
ME,23019,Medway,-103,688,285,388
ME,23019,Milford,215,1551,865,650
ME,23019,Millinocket,380,2305,1317,937
ME,23019,Mount Chase,-40,115,36,76
ME,23019,Newburgh,-33,837,395,428
ME,23019,Newport,-206,1613,684,890
ME,23019,Old Town,1008,3845,2366,1358
ME,23019,Orono,2365,5361,3761,1396
ME,23019,Orrington,-202,2219,986,1188
ME,23019,Passadumkeag,-50,194,70,120
ME,23019,Patten,-44,501,223,267
ME,23019,Penobscot Cty Townships,-23,284,127,150
ME,23019,Penobscot Nation Vot Dst,230,281,253,23
ME,23019,Plymouth,-109,655,265,374
ME,23019,Seboeis Plt.,6,26,16,10
ME,23019,Springfield,-49,155,52,101
ME,23019,Stacyville,-63,212,72,135
ME,23019,Stetson,-58,655,294,352
ME,23019,Veazie,98,1083,580,482
ME,23019,Webster Plt.,4,23,13,9
ME,23019,Winn,-46,178,66,112
ME,23019,Woodville,1,125,62,61
ME,23017,Andover,38,505,255,217
ME,23017,Bethel,359,1508,911,552
ME,23017,Brownfield,51,469,255,204
ME,23017,Buckfield,53,1021,518,465
ME,23017,Byron,2,79,39,37
ME,23017,Canton,63,473,260,197
ME,23017,Denmark,1,658,318,317
ME,23017,Dixfield,280,1233,750,470
ME,23017,Fryeburg,271,1614,920,649
ME,23017,Gilead,27,115,68,41
ME,23017,Greenwood,72,432,244,172
ME,23017,Hanover,17,162,88,71
ME,23017,Hartford,51,585,307,256
ME,23017,Hebron,67,703,370,303
ME,23017,Hiram,56,725,379,323
ME,23017,Lincoln Plt.,1,27,14,13
ME,23017,Lovell,27,655,333,306
ME,23017,Magalloway Plt.,-7,14,3,10
ME,23017,Mexico,542,1306,894,352
ME,23017,Newry,27,232,127,100
ME,23017,Norway,318,2455,1351,1033
ME,23017,Otisfield,79,985,517,438
ME,23017,Oxford,131,2010,1049,918
ME,23017,Oxford Cty Townships,75,281,169,94
ME,23017,Paris,325,2443,1345,1020
ME,23017,Peru,173,832,491,318
ME,23017,Porter,25,740,371,346
ME,23017,Roxbury,60,247,151,91
ME,23017,Rumford,756,2668,1671,915
ME,23017,Stoneham,31,155,90,59
ME,23017,Stow,59,190,122,63
ME,23017,Sumner,30,526,271,241
ME,23017,Sweden,29,226,125,96
ME,23017,Upton,0,0,0,0
ME,23017,Waterford,73,886,455,382
ME,23017,West Paris,117,860,470,353
ME,23017,Woodstock,7,714,351,344
ME,23015,Alna,89,467,271,182
ME,23015,Boothbay,175,2024,1082,907
ME,23015,Boothbay Harbor,182,1351,754,572
ME,23015,Bremen,106,490,293,187
ME,23015,Bristol,331,1803,1049,718
ME,23015,Damariscotta,268,1307,771,503
ME,23015,Dresden,132,989,544,412
ME,23015,Edgecomb,101,757,418,317
ME,23015,Jefferson,-66,1445,676,742
ME,23015,Monhegan Plt.,44,55,49,5
ME,23015,Newcastle,323,1194,744,421
ME,23015,Nobleboro,156,1108,622,466
ME,23015,Somerville,7,274,136,129
ME,23015,South Bristol,152,617,376,224
ME,23015,Southport,-16,431,207,223
ME,23015,Waldoboro,159,2563,1323,1164
ME,23015,Westport,33,486,254,221
ME,23015,Whitefield,162,1256,693,531
ME,23015,Wiscasset,76,2051,1036,960
ME,23013,Appleton,106,794,435,329
ME,23013,Camden,1287,3169,2201,914
ME,23013,Cushing,35,823,422,387
ME,23013,Friendship,-39,701,321,360
ME,23013,Hope,164,955,545,381
ME,23013,Isle Au Haut,43,57,48,5
ME,23013,Matinicus Isle Plt.,15,51,33,18
ME,23013,North Haven,132,274,199,67
ME,23013,Owl's Head,157,975,560,403
ME,23013,Rockland,1133,3354,2198,1065
ME,23013,Rockport,466,2149,1291,825
ME,23013,St. George,462,1545,980,518
ME,23013,South Thomaston,161,869,507,346
ME,23013,Thomaston,338,1399,860,522
ME,23013,Union,114,1353,712,598
ME,23013,Vinalhaven,342,710,519,177
ME,23013,Warren,21,1962,966,945
ME,23013,Washington,28,862,430,402
ME,23011,Albion,-132,1022,429,561
ME,23011,Augusta,1853,8780,5192,3339
ME,23011,Belgrade,62,1882,952,890
ME,23011,Benton,58,1421,731,673
ME,23011,Chelsea,89,1343,693,604
ME,23011,China,8,2291,1121,1113
ME,23011,Clinton,87,1583,817,730
ME,23011,Farmingdale,209,1594,887,678
ME,23011,Fayette,138,741,432,294
ME,23011,Gardiner,541,2981,1699,1158
ME,23011,Hallowell,664,1556,1090,426
ME,23011,Litchfield,31,1874,919,888
ME,23011,Manchester,94,1592,831,737
ME,23011,Monmouth,93,2306,1162,1069
ME,23011,Mount Vernon,119,950,517,398
ME,23011,Oakland,251,3207,1686,1435
ME,23011,Pittston,27,1578,779,752
ME,23011,Randolph,151,949,536,385
ME,23011,Readfield,231,1528,862,631
ME,23011,Rome,66,577,314,248
ME,23011,Sidney,-14,2302,1120,1134
ME,23011,Vassalboro,199,2318,1224,1025
ME,23011,Vienna,69,351,205,136
ME,23011,Waterville,2574,6964,4677,2103
ME,23011,Wayne,177,735,450,273
ME,23011,West Gardiner,33,2033,1004,971
ME,23011,Windsor,32,1226,610,578
ME,23011,Winslow,425,4077,2206,1781
ME,23011,Winthrop,381,3464,1877,1496
ME,23009,Amherst,-1,144,69,70
ME,23009,Aurora,-24,64,18,42
ME,23009,Bar Harbor,1363,3009,2142,779
ME,23009,Blue Hill,537,1760,1125,588
ME,23009,Brooklin,174,573,368,194
ME,23009,Brooksville,208,650,418,210
ME,23009,Bucksport,334,2435,1358,1024
ME,23009,Castine,97,591,338,241
ME,23009,Cranberry Isles,61,149,102,41
ME,23009,Dedham,47,1043,534,487
ME,23009,Deer Isle,465,1204,826,361
ME,23009,Eastbrook,-26,214,90,116
ME,23009,Ellsworth,107,3927,1950,1843
ME,23009,Franklin,-6,730,354,360
ME,23009,Frenchboro,6,40,21,15
ME,23009,Gouldsboro,34,980,494,460
ME,23009,Great Pond,-4,35,15,19
ME,23009,Hancock,1,1219,596,595
ME,23009,Hancock Cty Townships,0,0,0,0
ME,23009,Lamoine,21,1056,527,506
ME,23009,Mariaville,-19,274,123,142
ME,23009,Mount Desert,469,1381,911,442
ME,23009,Orland,204,1266,717,513
ME,23009,Osborn,-22,40,9,31
ME,23009,Otis,-121,410,144,265
ME,23009,Penobscot,-33,769,356,389
ME,23009,Sedgwick,214,699,447,233
ME,23009,Sorrento,27,192,104,77
ME,23009,Southwest Harbor,273,1052,653,380
ME,23009,Stonington,223,609,407,184
ME,23009,Sullivan,125,593,352,227
ME,23009,Surry,143,956,538,395
ME,23009,Swan's Island,-30,226,94,124
ME,23009,Tremont,244,879,550,306
ME,23009,Trenton,96,796,436,340
ME,23009,Verona,28,312,166,138
ME,23009,Waltham,-47,187,69,116
ME,23009,Winter Harbor,-33,274,112,145
ME,23007,Avon,22,236,127,105
ME,23007,Carrabassett Valley,142,463,295,153
ME,23007,Carthage,43,245,139,96
ME,23007,Chesterville,153,662,399,246
ME,23007,Coplin Plt.,2,83,42,40
ME,23007,Dallas Plt.,30,227,127,97
ME,23007,Eustis,25,373,191,166
ME,23007,Farmington,1153,3886,2441,1288
ME,23007,Franklin Cty Townships,6,24,14,8
ME,23007,Industry,42,450,238,196
ME,23007,Jay,747,2543,1615,868
ME,23007,Kingfield,66,621,331,265
ME,23007,New Sharon,50,841,433,383
ME,23007,New Vineyard,-8,399,191,199
ME,23007,Phillips,53,588,301,248
ME,23007,Rangeley,-16,694,334,350
ME,23007,Rangeley Plt.,-15,144,64,79
ME,23007,Sandy River Plt.,19,86,52,33
ME,23007,Strong,-10,702,337,347
ME,23007,Temple,122,315,216,94
ME,23007,Weld,31,289,154,123
ME,23007,Wilton,330,2241,1251,921
ME,23005,Baldwin,-59,799,354,413
ME,23005,Bridgton,302,2770,1501,1199
ME,23005,Brunswick,4199,16028,7853,3654
ME,23005,Cape Elizabeth,1857,6460,4018,2161
ME,23005,Casco,94,1940,993,899
ME,23005,Chebeague Island,145,296,216,71
ME,23005,Cumberland,398,4911,2619,2221
ME,23005,Falmouth,830,7571,4149,3319
ME,23005,Freeport,1540,5086,3266,1726
ME,23005,Frye Island,-21,56,17,38
ME,23005,Gorham,1381,9041,5123,3742
ME,23005,Gray,116,4519,2260,2144
ME,23005,Harpswell,569,3369,1940,1371
ME,23005,Harrison,110,1419,737,627
ME,23005,Long Island,72,200,132,60
ME,23005,Naples,74,2092,1057,983
ME,23005,New Gloucester,47,3147,1564,1517
ME,23005,North Yarmouth,417,2462,1418,1001
ME,23005,Portland,20249,36260,27736,7487
ME,23005,Pownal,128,993,550,422
ME,23005,Raymond,230,2672,1426,1196
ME,23005,Scarborough,1159,11727,6343,5184
ME,23005,Sebago,44,1013,516,472
ME,23005,South Portland,5852,14340,9956,4104
ME,23005,Standish,154,5054,2554,2400
ME,23005,Westbrook,2462,9668,5504,3042
ME,23005,Windham,390,7429,3817,3427
ME,23005,Yarmouth,1230,5573,3358,2128
ME,23003,Allagash,20,140,79,59
ME,23003,Amity,-21,94,35,56
ME,23003,Aroostook Cty Townships,-3,386,182,185
ME,23003,Ashland,95,564,327,232
ME,23003,Bancroft,-9,31,11,20
ME,23003,Blaine,-159,365,99,258
ME,23003,Bridgewater,-64,290,111,175
ME,23003,Caribou,245,3655,1910,1665
ME,23003,Cary Plt.,-29,109,39,68
ME,23003,Castle Hill,-42,196,76,118
ME,23003,Caswell,45,138,90,45
ME,23003,Chapman,23,246,119,96
ME,23003,Crystal,-35,142,51,86
ME,23003,Cyr Plt.,3,43,23,20
ME,23003,Dyer Brook,-35,129,43,78
ME,23003,Eagle Lake,124,439,276,152
ME,23003,Easton,-10,651,312,322
ME,23003,Fort Fairfield,123,1572,821,698
ME,23003,Fort Kent,751,2043,1376,625
ME,23003,Frenchville,242,583,406,164
ME,23003,Garfield Plt.,-3,51,24,27
ME,23003,Glenwood Plt.,-2,6,2,4
ME,23003,Grand Isle,122,231,174,52
ME,23003,Hamlin,29,97,62,33
ME,23003,Hammond,-1,49,24,25
ME,23003,Haynesville,-13,57,22,35
ME,23003,Hersey,-14,32,9,23
ME,23003,Hodgdon,-196,567,181,377
ME,23003,Houlton,-174,2501,1133,1307
ME,23003,Island Falls,-32,421,189,221
ME,23003,Limestone,187,859,511,324
ME,23003,Linneus,-131,441,151,282
ME,23003,Littleton,-103,461,171,274
ME,23003,Ludlow,-26,229,100,126
ME,23003,Macwahoc Plt.,-9,46,18,27
ME,23003,Madawaska,1029,2089,1540,511
ME,23003,Mapleton,-10,1066,521,531
ME,23003,Mars Hill,-199,766,276,475
ME,23003,Masardis,30,155,90,60
ME,23003,Merrill,-2,128,62,64
ME,23003,Monticello,-60,382,158,218
ME,23003,Moro Plt.,-20,23,1,21
ME,23003,Nashville Plt.,6,18,12,6
ME,23003,New Canada,47,257,148,101
ME,23003,New Limerick,-44,317,134,178
ME,23003,New Sweden,24,347,182,158
ME,23003,Oakfield,-57,360,145,202
ME,23003,Orient,6,93,48,42
ME,23003,Oxbow Plt.,20,145,80,60
ME,23003,Perham,-56,174,58,114
ME,23003,Portage Lake,16,241,125,109
ME,23003,Presque Isle,346,4230,2231,1885
ME,23003,Reed Plt.,-30,81,25,55
ME,23003,Saint Agatha,238,567,399,161
ME,23003,St. Francis,96,250,172,76
ME,23003,St. John Plt.,24,143,80,56
ME,23003,Sherman,-147,602,218,365
ME,23003,Smyrna,-12,125,55,67
ME,23003,Stockholm,38,147,91,53
ME,23003,Van Buren,474,913,684,210
ME,23003,Wade,-24,128,50,74
ME,23003,Wallagrass,127,283,204,77
ME,23003,Washburn,-72,776,346,418
ME,23003,Westfield,-29,269,117,146
ME,23003,Westmanland,0,43,21,21
ME,23003,Weston,-31,131,50,81
ME,23003,Winterville Plt.,30,134,79,49
ME,23003,Woodland,-41,619,285,326
ME,23001,Auburn,2041,11289,6503,4462
ME,23001,Durham,57,2295,1137,1080
ME,23001,Greene,-28,2318,1111,1139
ME,23001,Leeds,87,1167,609,522
ME,23001,Lewiston,3772,15715,9550,5778
ME,23001,Lisbon,155,4735,2383,2228
ME,23001,Livermore,143,1209,661,518
ME,23001,Livermore Falls,375,1349,842,467
ME,23001,Mechanic Falls,75,1475,753,678
ME,23001,Minot,-67,1509,704,771
ME,23001,Poland,216,3032,1585,1369
ME,23001,Sabattus,134,2520,1294,1160
ME,23001,Turner,-156,3094,1429,1585
ME,23001,Wales,-102,832,351,453
LA,22127,Winn,-2620,6532,1919,4539
LA,22125,West Feliciana,-816,5777,2441,3257
LA,22123,West Carroll,-2775,4548,853,3628
LA,22121,West Baton Rouge,-1228,12772,5692,6920
LA,22119,Webster,-4595,18413,6802,11397
LA,22117,Washington,-5119,18100,6351,11470
LA,22115,Vernon,-8973,15606,3173,12146
LA,22113,Vermilion,-13191,24984,5718,18909
LA,22111,Union,-4486,10766,3075,7561
LA,22109,Terrebonne,-17429,42335,12071,29500
LA,22107,Tensas,334,2812,1564,1230
LA,22105,Tangipahoa,-13863,50090,17720,31583
LA,22103,St. Tammany,-58987,112884,25723,84710
LA,22101,St. Mary,-4435,23636,9448,13883
LA,22099,St. Martin,-6234,25430,9419,15653
LA,22097,St. Landry,-1807,41647,19668,21475
LA,22095,St. John the Baptist,5558,21122,13178,7620
LA,22093,St. James,1846,12391,7055,5209
LA,22091,St. Helena,1477,7093,4233,2756
LA,22089,St. Charles,-7042,25330,8894,15936
LA,22087,St. Bernard,-3445,13944,5052,8497
LA,22085,Sabine,-5541,10050,2194,7735
LA,22083,Richland,-3242,11507,4074,7316
LA,22081,Red River,-230,4807,2253,2483
LA,22079,Rapides,-17147,58008,20040,37187
LA,22077,Pointe Coupee,-1112,12147,5436,6548
LA,22075,Plaquemines,-2872,10235,3597,6469
LA,22073,Ouachita,-14298,68437,26629,40927
LA,22071,Orleans,98232,157233,126199,27967
LA,22069,Natchitoches,-1136,17257,7941,9077
LA,22067,Morehouse,-704,12613,5887,6591
LA,22065,Madison,1154,5187,3154,2000
LA,22063,Livingston,-38040,54033,7448,45488
LA,22061,Lincoln,-2784,18974,7947,10731
LA,22059,LaSalle,-4962,6572,764,5726
LA,22057,Lafourche,-18789,38725,9543,28332
LA,22055,Lafayette,-33223,98637,31766,64989
LA,22053,Jeff Davis,-6531,13733,3483,10014
LA,22051,Jefferson,-32325,175733,70000,102325
LA,22049,Jackson,-2827,7529,2305,5132
LA,22047,Iberville,2277,17014,9548,7271
LA,22045,Iberia,-8761,33392,12129,20890
LA,22043,Grant,-5661,8666,1421,7082
LA,22041,Franklin,-3373,9336,2921,6294
LA,22039,Evangeline,-4846,15765,5330,10176
LA,22037,East Feliciana,-749,10209,4648,5397
LA,22035,East Carroll,1122,3384,2244,1122
LA,22033,East Baton Rouge,10225,197912,102460,92235
LA,22031,DeSoto,-1801,13050,5552,7353
LA,22029,Concordia,-1617,9380,3833,5450
LA,22027,Claiborne,-635,6732,3014,3649
LA,22025,Catahoula,-1336,4193,1408,2744
LA,22023,Cameron,-2852,3744,408,3260
LA,22021,Caldwell,-2624,4716,1016,3640
LA,22019,Calcasieu,-23487,81718,28357,51844
LA,22017,Caddo,5501,111516,57879,52378
LA,22015,Bossier,-22031,48559,12955,34986
LA,22013,Bienville,-151,7203,3490,3641
LA,22011,Beauregard,-8284,14223,2827,11111
LA,22009,Avoyelles,-4592,17027,6075,10667
LA,22007,Assumption,-1328,10991,4754,6082
LA,22005,Ascension,-17503,51056,16343,33846
LA,22003,Allen,-3879,9306,2616,6495
LA,22001,Acadia,-13372,26834,6559,19931
KY,21239,Woodford,-2335,12331,4883,7218
KY,21237,Wolfe,-566,2559,976,1542
KY,21235,Whitley,-7549,13068,2683,10232
KY,21233,Webster,-1842,5470,1765,3607
KY,21231,Wayne,-3434,7210,1855,5289
KY,21229,Washington,-1826,5218,1669,3495
KY,21227,Warren,-9579,43889,16805,26384
KY,21225,Union,-2011,5975,1941,3952
KY,21223,Trimble,-778,3540,1355,2133
KY,21221,Trigg,-2405,6740,2115,4520
KY,21219,Todd,-1844,4718,1403,3247
KY,21217,Taylor,-4267,10946,3284,7551
KY,21215,Spencer,-3177,8431,2549,5726
KY,21213,Simpson,-1705,7089,2650,4355
KY,21211,Shelby,-5156,18659,6634,11790
KY,21209,Scott,-5147,20565,7532,12679
KY,21207,Russell,-4901,7907,1445,6346
KY,21205,Rowan,-597,7641,3438,4035
KY,21203,Rockcastle,-3931,6216,1097,5028
KY,21201,Robertson,-239,935,340,579
KY,21199,Pulaski,-15738,26003,4976,20714
KY,21197,Powell,-1106,4441,1620,2726
KY,21195,Pike,-11944,23632,5645,17589
KY,21193,Perry,-5993,10240,2047,8040
KY,21191,Pendleton,-1697,5534,1859,3556
KY,21189,Owsley,-996,1580,283,1279
KY,21187,Owen,-1470,4555,1501,2971
KY,21185,Oldham,-10939,29873,9240,20179
KY,21183,Ohio,-3483,9646,2987,6470
KY,21181,Nicholas,-635,2580,948,1583
KY,21179,Nelson,-3062,18532,7611,10673
KY,21177,Muhlenberg,-2991,12737,4771,7762
KY,21175,Morgan,-1652,4472,1369,3021
KY,21173,Montgomery,-2697,10248,3701,6398
KY,21171,Monroe,-2826,4746,936,3762
KY,21169,Metcalfe,-1251,4184,1425,2676
KY,21167,Mercer,-3854,9936,2966,6820
KY,21165,Menifee,-436,2598,1048,1484
KY,21163,Meade,-2484,10915,4122,6606
KY,21161,Mason,-1605,6879,2592,4197
KY,21159,Martin,-2606,3824,574,3180
KY,21157,Marshall,-5380,15714,5022,10402
KY,21155,Marion,-382,7316,3418,3800
KY,21153,Magoffin,-1958,4905,1433,3391
KY,21151,Madison,-9616,33317,11512,21128
KY,21149,McLean,-1273,4200,1432,2705
KY,21147,McCreary,-3495,5704,1069,4564
KY,21145,McCracken,-9917,30540,10062,19979
KY,21143,Lyon,-1039,3838,1373,2412
KY,21141,Logan,-3430,10509,3469,6899
KY,21139,Livingston,-1743,4511,1346,3089
KY,21137,Lincoln,-3834,9152,2582,6416
KY,21135,Lewis,-1984,4769,1342,3326
KY,21133,Letcher,-5109,8758,1702,6811
KY,21131,Leslie,-4006,4950,433,4439
KY,21129,Lee,-1382,2623,595,1977
KY,21127,Lawrence,-2475,5592,1520,3995
KY,21125,Laurel,-14246,22408,3905,18151
KY,21123,LaRue,-2178,5764,1733,3911
KY,21121,Knox,-5983,11100,2484,8467
KY,21119,Knott,-2710,5693,1420,4130
KY,21117,Kenton,-16470,67679,24917,41387
KY,21115,Johnson,-5372,9035,1723,7095
KY,21113,Jessamine,-8231,20620,6001,14232
KY,21111,Jefferson,37749,339500,186164,148415
KY,21109,Jackson,-3753,5061,612,4365
KY,21107,Hopkins,-7892,19765,5789,13681
KY,21105,Hickman,-745,2139,686,1431
KY,21103,Henry,-1411,6584,2529,3940
KY,21101,Henderson,-2205,18614,8091,10296
KY,21099,Hart,-1973,6621,2283,4256
KY,21097,Harrison,-2085,7163,2471,4556
KY,21095,Harlan,-6823,10658,1830,8653
KY,21093,Hardin,-8143,39212,15214,23357
KY,21091,Hancock,-379,4133,1833,2212
KY,21089,Greenup,-2828,15159,6027,8855
KY,21087,Green,-2469,4856,1165,3634
KY,21085,Grayson,-3660,9269,2744,6404
KY,21083,Graves,-6152,15493,4547,10699
KY,21081,Grant,-2854,8606,2810,5664
KY,21079,Garrard,-3649,7077,1661,5310
KY,21077,Gallatin,-520,3060,1238,1758
KY,21075,Fulton,-403,2481,1022,1425
KY,21073,Franklin,190,23337,11535,11345
KY,21071,Floyd,-5051,14890,4733,9784
KY,21069,Fleming,-1869,5782,1911,3780
KY,21067,Fayette,1285,125821,62078,60793
KY,21065,Estill,-2393,5184,1356,3749
KY,21063,Elliott,60,2399,1186,1126
KY,21061,Edmonson,-1858,4664,1374,3232
KY,21059,Daviess,-8884,42079,16208,25092
KY,21057,Cumberland,-1617,2853,599,2216
KY,21055,Crittenden,-1879,3854,960,2839
KY,21053,Clinton,-2817,4393,752,3569
KY,21051,Clay,-5065,7383,1111,6176
KY,21049,Clark,-4703,15410,5228,9931
KY,21047,Christian,-5223,21953,8252,13475
KY,21045,Casey,-3818,6091,1086,4904
KY,21043,Carter,-1896,8906,3383,5279
KY,21041,Carroll,-370,3680,1629,1999
KY,21039,Carlisle,-1085,2619,750,1835
KY,21037,Campbell,-9160,40173,15080,24240
KY,21035,Calloway,-4124,15064,5314,9438
KY,21033,Caldwell,-2052,5860,1852,3904
KY,21031,Butler,-2423,5058,1293,3716
KY,21029,Bullitt,-11335,31775,9971,21306
KY,21027,Breckinridge,-2200,7967,2825,5025
KY,21025,Breathitt,-1756,5008,1562,3318
KY,21023,Bracken,-882,3230,1147,2029
KY,21021,Boyle,-3232,12368,4471,7703
KY,21019,Boyd,-3107,19040,7776,10883
KY,21017,Bourbon,-1617,7909,3075,4692
KY,21015,Boone,-20292,52495,15628,35920
KY,21013,Bell,-4903,9482,2224,7127
KY,21011,Bath,-505,4122,1770,2275
KY,21009,Barren,-5522,16565,5400,10922
KY,21007,Ballard,-1458,3895,1189,2647
KY,21005,Anderson,-3507,10318,3315,6822
KY,21003,Allen,-3376,7099,1808,5184
KY,21001,Adair,-4181,7600,1660,5841
KS,20209,Wyandotte,17992,49422,33265,15273
KS,20207,Woodson,-653,1435,377,1030
KS,20205,Wilson,-1999,3699,813,2812
KS,20203,Wichita,-664,987,157,821
KS,20201,Washington,-1785,2863,515,2300
KS,20199,Wallace,-634,781,68,702
KS,20197,Wabaunsee,-1322,3229,908,2230
KS,20195,Trego,-941,1544,289,1230
KS,20193,Thomas,-2153,3388,576,2729
KS,20191,Sumner,-3545,8989,2617,6162
KS,20189,Stevens,-1483,1998,241,1724
KS,20187,Stanton,-436,713,135,571
KS,20185,Stafford,-979,1833,403,1382
KS,20183,Smith,-1253,1983,345,1598
KS,20181,Sherman,-1392,2606,575,1967
KS,20179,Sheridan,-971,1320,165,1136
KS,20177,Shawnee,-1267,74844,35959,37226
KS,20175,Seward,-2102,4955,1393,3495
KS,20173,Sedgwick,-35038,177852,69373,104411
KS,20171,Scott,-1431,2019,271,1702
KS,20169,Saline,-6787,21102,6910,13697
KS,20167,Russell,-1921,3140,584,2505
KS,20165,Rush,-790,1549,361,1151
KS,20163,Rooks,-1761,2625,398,2159
KS,20161,Riley,-2570,20266,8587,11157
KS,20159,Rice,-1732,3622,899,2631
KS,20157,Republic,-1628,2640,470,2098
KS,20155,Reno,-7510,23869,7888,15398
KS,20153,Rawlins,-1023,1420,184,1207
KS,20151,Pratt,-1756,3752,974,2730
KS,20149,Pottawatomie,-4401,9303,2291,6692
KS,20147,Phillips,-1740,2537,376,2116
KS,20145,Pawnee,-1104,2565,704,1808
KS,20143,Ottawa,-1712,2888,548,2260
KS,20141,Osborne,-1128,1802,320,1448
KS,20139,Osage,-2108,6771,2228,4336
KS,20137,Norton,-1462,2296,393,1855
KS,20135,Ness,-979,1417,211,1190
KS,20133,Neosho,-2181,6359,2012,4193
KS,20131,Nemaha,-2890,4959,988,3878
KS,20129,Morton,-870,1247,180,1050
KS,20127,Morris,-1045,2526,705,1750
KS,20125,Montgomery,-5011,12093,3406,8417
KS,20123,Mitchell,-1717,2923,576,2293
KS,20121,Miami,-5091,14642,4635,9726
KS,20119,Meade,-1140,1648,254,1394
KS,20117,Marshall,-1672,4679,1451,3123
KS,20115,Marion,-2494,5368,1371,3865
KS,20113,McPherson,-5015,12060,3384,8399
KS,20111,Lyon,-1386,11614,4972,6358
KS,20109,Logan,-890,1302,194,1084
KS,20107,Linn,-1971,4294,1108,3079
KS,20105,Lincoln,-864,1459,284,1148
KS,20103,Leavenworth,-5753,28532,11072,16825
KS,20101,Lane,-562,917,170,732
KS,20099,Labette,-1594,7907,3074,4668
KS,20097,Kiowa,-810,1133,160,970
KS,20095,Kingman,-1640,3199,731,2371
KS,20093,Kearny,-799,1341,261,1060
KS,20091,Johnson,-47791,268145,107651,155442
KS,20089,Jewell,-995,1477,225,1220
KS,20087,Jefferson,-1764,7725,2883,4647
KS,20085,Jackson,-1606,5474,1870,3476
KS,20083,Hodgeman,-679,1050,178,857
KS,20081,Haskell,-929,1355,202,1131
KS,20079,Harvey,-3190,13805,5162,8352
KS,20077,Harper,-1187,2335,536,1723
KS,20075,Hamilton,-519,857,159,678
KS,20073,Greenwood,-1333,2706,653,1986
KS,20071,Greeley,-427,665,112,539
KS,20069,Gray,-1264,1901,304,1568
KS,20067,Grant,-1305,2215,437,1742
KS,20065,Graham,-796,1319,248,1044
KS,20063,Gove,-981,1368,174,1155
KS,20061,Geary,-1084,7526,3158,4242
KS,20059,Franklin,-3282,10806,3611,6893
KS,20057,Ford,-2991,8082,2468,5459
KS,20055,Finney,-2801,7593,2307,5108
KS,20053,Ellsworth,-1209,2677,696,1905
KS,20051,Ellis,-5593,12779,3464,9057
KS,20049,Elk,-763,1356,277,1040
KS,20047,Edwards,-757,1365,291,1048
KS,20045,Douglas,10984,46283,28012,17028
KS,20043,Doniphan,-1512,3369,885,2397
KS,20041,Dickinson,-3747,7854,1962,5709
KS,20039,Decatur,-953,1533,266,1219
KS,20037,Crawford,-935,14385,6545,7480
KS,20035,Cowley,-3713,12444,4219,7932
KS,20033,Comanche,-615,915,141,756
KS,20031,Coffey,-1976,3839,884,2860
KS,20029,Cloud,-1935,3957,951,2886
KS,20027,Clay,-1904,3584,811,2715
KS,20025,Clark,-620,1000,171,791
KS,20023,Cheyenne,-926,1422,231,1157
KS,20021,Cherokee,-2477,8396,2868,5345
KS,20019,Chautauqua,-942,1502,259,1201
KS,20017,Chase,-514,1233,343,857
KS,20015,Butler,-10640,25452,7124,17764
KS,20013,Brown,-1699,3865,1039,2738
KS,20011,Bourbon,-2071,6118,1951,4022
KS,20009,Barton,-6439,12010,2693,9132
KS,20007,Barber,-1280,2282,473,1753
KS,20005,Atchison,-1350,6499,2486,3836
KS,20003,Anderson,-1309,3274,937,2246
KS,20001,Allen,-1419,5221,1842,3261
IA,19197,Wright,-515,6174,2794,3309
IA,19195,Worth,600,4143,2343,1743
IA,19193,Woodbury,-110,44702,22026,22136
IA,19191,Winneshiek,1627,11016,6245,4618
IA,19189,Winnebago,-2,5878,2895,2897
IA,19187,Webster,1005,18118,9458,8453
IA,19185,Wayne,-332,2886,1251,1583
IA,19183,Washington,-459,10880,5081,5540
IA,19181,Warren,-510,25875,12521,13031
IA,19179,Wapello,1839,15630,8616,6777
IA,19177,Van Buren,-660,3540,1398,2058
IA,19175,Union,229,5899,3029,2800
IA,19173,Taylor,-419,2978,1261,1680
IA,19171,Tama,661,8930,4737,4076
IA,19169,Story,6383,46529,25940,19557
IA,19167,Sioux,-11678,17181,2683,14361
IA,19165,Shelby,-1435,6456,2468,3903
IA,19163,Scott,12358,89826,50581,38223
IA,19161,Sac,-969,5256,2117,3086
IA,19159,Ringgold,-185,2578,1181,1366
IA,19157,Poweshiek,898,9858,5307,4409
IA,19155,Pottawattamie,-2404,41679,19347,21751
IA,19153,Polk,32235,227563,128264,96029
IA,19151,Pocahontas,-870,3992,1518,2388
IA,19149,Plymouth,-4429,12909,4148,8577
IA,19147,Palo Alto,-525,4857,2124,2649
IA,19145,Page,-1750,7014,2588,4338
IA,19143,Osceola,-1316,3179,909,2225
IA,19141,O'Brien,-3295,7295,1964,5259
IA,19139,Muscatine,3061,19726,11213,8152
IA,19137,Montgomery,-1080,5000,1919,2999
IA,19135,Monroe,-293,3802,1729,2022
IA,19133,Monona,-457,4707,2098,2555
IA,19131,Mitchell,188,5580,2831,2643
IA,19129,Mills,-1369,7169,2842,4211
IA,19127,Marshall,1674,18727,10085,8411
IA,19125,Marion,-2332,17536,7478,9810
IA,19123,Mahaska,-2213,10777,4207,6420
IA,19121,Madison,-984,8140,3508,4492
IA,19119,Lyon,-3549,6466,1416,4965
IA,19117,Lucas,-271,4273,1977,2248
IA,19115,Louisa,33,4921,2449,2416
IA,19113,Linn,20601,117122,68028,47427
IA,19111,Lee,2641,16488,9428,6787
IA,19109,Kossuth,-1090,8833,3824,4914
IA,19107,Keokuk,-542,5221,2298,2840
IA,19105,Jones,802,10371,5514,4712
IA,19103,Johnson,26534,74928,50090,23556
IA,19101,Jefferson,1343,8405,4772,3429
IA,19099,Jasper,1372,19385,10240,8868
IA,19097,Jackson,1706,10166,5877,4171
IA,19095,Iowa,-433,8788,4118,4551
IA,19093,Ida,-959,3626,1317,2276
IA,19091,Humboldt,-1132,5124,1967,3099
IA,19089,Howard,974,4625,2767,1793
IA,19087,Henry,-574,9613,4451,5025
IA,19085,Harrison,-928,7282,3131,4059
IA,19083,Hardin,-626,8775,4021,4647
IA,19081,Hancock,-800,5881,2506,3306
IA,19079,Hamilton,-210,7872,3776,3986
IA,19077,Guthrie,-599,5843,2565,3164
IA,19075,Grundy,-1590,6890,2615,4205
IA,19073,Greene,-4,4804,2369,2373
IA,19071,Fremont,-335,3655,1636,1971
IA,19069,Franklin,-562,5133,2256,2818
IA,19067,Floyd,1208,8228,4674,3466
IA,19065,Fayette,1225,10309,5709,4484
IA,19063,Emmet,-412,4646,2087,2499
IA,19061,Dubuque,7335,50516,28600,21265
IA,19059,Dickinson,-1823,10118,4088,5911
IA,19057,Des Moines,3743,20264,11873,8130
IA,19055,Delaware,-23,9323,4605,4628
IA,19053,Decatur,-155,3812,1790,1945
IA,19051,Davis,-615,3738,1518,2133
IA,19049,Dallas,-4455,37799,16466,20921
IA,19047,Crawford,-549,6686,3035,3584
IA,19045,Clinton,5700,24873,15123,9423
IA,19043,Clayton,622,9035,4768,4146
IA,19041,Clay,-1571,8400,3363,4934
IA,19039,Clarke,63,4398,2187,2124
IA,19037,Chickasaw,716,6462,3552,2836
IA,19035,Cherokee,-1033,6367,2623,3656
IA,19033,Cerro Gordo,3120,23548,13204,10084
IA,19031,Cedar,421,9548,4931,4510
IA,19029,Cass,-1356,7167,2856,4212
IA,19027,Carroll,-665,10581,4912,5577
IA,19025,Calhoun,-658,5190,2232,2890
IA,19023,Butler,-783,7510,3321,4104
IA,19021,Buena Vista,-865,8322,3683,4548
IA,19019,Buchanan,1460,10478,5903,4443
IA,19017,Bremer,327,13218,6710,6383
IA,19015,Boone,917,14237,7457,6540
IA,19013,Black Hawk,13260,66205,39338,26078
IA,19011,Benton,-85,13959,6850,6935
IA,19009,Audubon,-192,3439,1608,1800
IA,19007,Appanoose,-219,6176,2934,3153
IA,19005,Allamakee,281,6824,3511,3230
IA,19003,Adams,-85,2158,1018,1103
IA,19001,Adair,-322,3959,1788,2110
IN,18183,Whitley,-5837,15005,4420,10257
IN,18181,White,-2335,9901,3635,5970
IN,18179,Wells,-5821,12922,3434,9255
IN,18177,Wayne,-3730,25458,10591,14321
IN,18175,Washington,-2623,10725,3909,6532
IN,18173,Warrick,-6559,24627,8791,15350
IN,18171,Warren,-1053,3798,1324,2377
IN,18169,Wabash,-4599,12702,3929,8528
IN,18167,Vigo,339,39843,19707,19368
IN,18165,Vermillion,-447,6578,2979,3426
IN,18163,Vanderburgh,-7845,72416,31659,39504
IN,18161,Union,-1004,3099,1018,2022
IN,18159,Tipton,-2341,7364,2432,4773
IN,18157,Tippecanoe,-2066,56696,26642,28708
IN,18155,Switzerland,-435,3397,1437,1872
IN,18153,Sullivan,-1711,8289,3191,4902
IN,18151,Steuben,-3696,13677,4846,8542
IN,18149,Starke,-929,8752,3809,4738
IN,18147,Spencer,-1489,9725,4026,5515
IN,18145,Shelby,-5615,16743,5357,10972
IN,18143,Scott,-541,8716,3998,4539
IN,18141,St. Joseph,3883,110644,56458,52575
IN,18139,Rush,-2412,7026,2221,4633
IN,18137,Ripley,-4243,10982,3241,7484
IN,18135,Randolph,-2450,10188,3768,6218
IN,18133,Putnam,-4500,13813,4504,9004
IN,18131,Pulaski,-1467,5399,1899,3366
IN,18129,Posey,-2896,12216,4531,7427
IN,18127,Porter,2753,72487,36950,34197
IN,18125,Pike,-1502,5924,2125,3627
IN,18123,Perry,911,7866,4314,3403
IN,18121,Parke,-2122,6504,2106,4228
IN,18119,Owen,-2239,8107,2823,5062
IN,18117,Orange,-1676,7753,2939,4615
IN,18115,Ohio,-765,2812,992,1757
IN,18113,Noble,-5451,16244,5229,10680
IN,18111,Newton,-1079,5652,2212,3291
IN,18109,Morgan,-11622,28251,7969,19591
IN,18107,Montgomery,-5524,14349,4244,9768
IN,18105,Monroe,6631,40200,22885,16254
IN,18103,Miami,-3943,12758,4220,8163
IN,18101,Martin,-1911,4742,1351,3262
IN,18099,Marshall,-5124,17751,6136,11260
IN,18097,Marion,79343,357745,215474,136131
IN,18095,Madison,-2351,52340,24404,26755
IN,18093,Lawrence,-5843,17822,5779,11622
IN,18091,LaPorte,5495,43657,24104,18609
IN,18089,Lake,62427,201648,130824,68397
IN,18087,LaGrange,-3330,9311,2897,6227
IN,18085,Kosciusko,-15691,30039,6862,22553
IN,18083,Knox,-4384,15145,5228,9612
IN,18081,Johnson,-22056,57362,17080,39136
IN,18079,Jennings,-2294,10237,3818,6112
IN,18077,Jefferson,-1368,13120,5728,7096
IN,18075,Jay,-1580,7897,3063,4643
IN,18073,Jasper,-3283,12891,4672,7955
IN,18071,Jackson,-4581,16704,5838,10419
IN,18069,Huntington,-6266,15753,4596,10862
IN,18067,Howard,-5187,36194,15097,20284
IN,18065,Henry,-3223,18996,7613,10836
IN,18063,Hendricks,-23208,66590,21100,44308
IN,18061,Harrison,-4029,17646,6600,10629
IN,18059,Hancock,-13447,32758,9303,22750
IN,18057,Hamilton,-46946,136803,43794,90740
IN,18055,Greene,-4117,13101,4340,8457
IN,18053,Grant,-5559,25258,9589,15148
IN,18051,Gibson,-4559,14718,4928,9487
IN,18049,Fulton,-2694,8120,2621,5315
IN,18047,Franklin,-4514,10549,2907,7421
IN,18045,Fountain,-2427,7103,2233,4660
IN,18043,Floyd,-5063,35283,14805,19868
IN,18041,Fayette,-1491,8816,3553,5044
IN,18039,Elkhart,-17972,67768,24376,42348
IN,18037,Dubois,-5132,18542,6522,11654
IN,18035,Delaware,1399,44924,22630,21231
IN,18033,DeKalb,-5167,16314,5419,10586
IN,18031,Decatur,-4178,10303,2941,7119
IN,18029,Dearborn,-8864,22352,6527,15391
IN,18027,Daviess,-5201,10246,2437,7638
IN,18025,Crawford,-378,4586,2040,2418
IN,18023,Clinton,-3031,9879,3307,6338
IN,18021,Clay,-3435,10922,3630,7065
IN,18019,Clark,-4647,47062,20775,25422
IN,18017,Cass,-3067,14137,5365,8432
IN,18015,Carroll,-2362,7793,2631,4993
IN,18013,Brown,-1274,7590,3056,4330
IN,18011,Boone,-10481,27725,8326,18807
IN,18009,Blackford,-783,4740,1927,2710
IN,18007,Benton,-1170,3577,1159,2329
IN,18005,Bartholomew,-7461,29313,10622,18083
IN,18003,Allen,-24544,146405,59834,84378
IN,18001,Adams,-5136,12998,3800,8936
IL,17203,Woodford,-7383,18848,5564,12947
IL,17201,Winnebago,6612,116101,60334,53722
IL,17199,Williamson,-7258,29079,10622,17880
IL,17197,Will,9156,249708,127522,118366
IL,17195,Whiteside,3717,21492,12393,8676
IL,17193,White,-2542,7059,2187,4729
IL,17191,Wayne,-4470,7676,1514,5984
IL,17189,Washington,-2339,7398,2448,4787
IL,17187,Warren,433,7476,3893,3460
IL,17185,Wabash,-1885,5127,1588,3473
IL,17183,Vermilion,-4115,26153,10773,14888
IL,17181,Union,-1816,8274,3135,4951
IL,17179,Tazewell,-10881,60903,24385,35266
IL,17177,Stephenson,-788,17029,7954,8742
IL,17175,Stark,-432,2661,1095,1527
IL,17173,Shelby,-3501,10383,3336,6837
IL,17171,Scott,-676,2554,910,1586
IL,17169,Schuyler,-336,3882,1726,2062
IL,17167,Sangamon,-8170,94032,41961,50131
IL,17165,Saline,-3106,10713,3697,6803
IL,17163,St. Clair,17139,118379,66749,49610
IL,17161,Rock Island,14193,64880,39081,24888
IL,17159,Richland,-2390,7274,2360,4750
IL,17157,Randolph,-2531,14380,5753,8284
IL,17155,Putnam,58,3132,1558,1500
IL,17153,Pulaski,-173,3001,1389,1562
IL,17151,Pope,-862,2219,649,1511
IL,17149,Pike,-2577,7275,2276,4853
IL,17147,Piatt,-2331,8697,3081,5412
IL,17145,Perry,-1684,9533,3813,5497
IL,17143,Peoria,3433,78060,40050,36617
IL,17141,Ogle,-3905,23342,9504,13409
IL,17139,Moultrie,-1639,6052,2142,3781
IL,17137,Morgan,-2170,14071,5792,7962
IL,17135,Montgomery,-1718,12120,5053,6771
IL,17133,Monroe,-4674,17407,6205,10879
IL,17131,Mercer,629,8525,4503,3874
IL,17129,Menard,-1849,6142,2095,3944
IL,17127,Massac,-2186,6492,2092,4278
IL,17125,Mason,-398,6272,2867,3265
IL,17123,Marshall,-835,5842,2452,3287
IL,17121,Marion,-3019,15728,6210,9229
IL,17119,Madison,-1668,122203,58813,60481
IL,17117,Macoupin,-1469,20947,9440,10909
IL,17115,Macon,-2561,48742,22688,25249
IL,17113,McLean,-8048,72756,31590,39638
IL,17111,McHenry,-11797,133589,59691,71488
IL,17109,McDonough,-185,12439,5957,6142
IL,17107,Logan,-3861,12037,3974,7835
IL,17105,Livingston,-4731,15019,5014,9745
IL,17103,Lee,-1114,15275,6932,8046
IL,17101,Lawrence,-1843,5984,2010,3853
IL,17099,LaSalle,-184,47146,23023,23207
IL,17097,Lake,22943,284032,151552,128609
IL,17095,Knox,3860,22517,12993,9133
IL,17093,Kendall,-1857,45042,21219,23076
IL,17091,Kankakee,-1541,45452,21574,23115
IL,17089,Kane,1618,183631,91120,89502
IL,17087,Johnson,-2388,5666,1571,3959
IL,17085,JoDaviess,131,11411,5660,5529
IL,17083,Jersey,-2376,9940,3656,6032
IL,17081,Jefferson,-3725,16303,6080,9805
IL,17079,Jasper,-2077,5038,1434,3511
IL,17077,Jackson,2176,21190,11306,9130
IL,17075,Iroquois,-5707,12770,3408,9115
IL,17073,Henry,752,24279,12316,11564
IL,17071,Henderson,439,3563,1977,1538
IL,17069,Hardin,-793,2330,742,1535
IL,17067,Hancock,-1564,8229,3246,4810
IL,17065,Hamilton,-1300,3935,1266,2566
IL,17063,Grundy,-1879,20956,9319,11198
IL,17061,Greene,-1423,5614,2023,3446
IL,17059,Gallatin,-464,2569,1028,1492
IL,17057,Fulton,1702,15337,8324,6622
IL,17055,Franklin,-3008,17891,7245,10253
IL,17053,Ford,-2571,6000,1654,4225
IL,17051,Fayette,-3102,8963,2848,5950
IL,17049,Effingham,-8636,16595,3855,12491
IL,17047,Edwards,-1648,3225,754,2402
IL,17045,Edgar,-2562,7810,2563,5125
IL,17043,DuPage,4078,397173,197411,193333
IL,17041,Douglas,-2905,7889,2426,5331
IL,17039,DeWitt,-1978,7338,2598,4576
IL,17037,DeKalb,2265,41020,21171,18906
IL,17035,Cumberland,-1866,5290,1640,3506
IL,17033,Crawford,-2722,8598,2855,5577
IL,17031,Cook,959919,1944401,1439123,479204
IL,17029,Coles,-2371,21338,9252,11623
IL,17027,Clinton,-4916,16394,5577,10493
IL,17025,Clay,-2603,5899,1581,4184
IL,17023,Clark,-2551,7843,2587,5138
IL,17021,Christian,-3386,14682,5487,8873
IL,17019,Champaign,5292,77620,40378,35086
IL,17017,Cass,-657,4858,2050,2707
IL,17015,Carroll,107,7370,3658,3551
IL,17013,Calhoun,-360,2574,1079,1439
IL,17011,Bureau,-33,16599,8118,8151
IL,17009,Brown,-724,2362,787,1511
IL,17007,Boone,-1216,21333,9868,11084
IL,17005,Bond,-1075,7316,3016,4091
IL,17003,Alexander,476,3495,1961,1485
IL,17001,Adams,-10744,30538,9627,20371
ID,16087,Washington,-2024,4330,1104,3128
ID,16085,Valley,-569,4919,2095,2664
ID,16083,Twin Falls,-12232,28142,7541,19773
ID,16081,Teton,-532,4523,1926,2458
ID,16079,Shoshone,-422,5148,2277,2699
ID,16077,Power,-888,2903,982,1870
ID,16075,Payette,-3733,8495,2271,6004
ID,16073,Owyhee,-1961,3723,833,2794
ID,16071,Oneida,-1621,2089,217,1838
ID,16069,Nez Perce,-3516,16848,6451,9967
ID,16067,Minidoka,-4052,6973,1390,5442
ID,16065,Madison,-12613,14412,832,13445
ID,16063,Lincoln,-712,1622,429,1141
ID,16061,Lewis,-777,1612,396,1173
ID,16059,Lemhi,-2069,4109,960,3029
ID,16057,Latah,717,16759,8306,7589
ID,16055,Kootenai,-20523,59764,18824,39347
ID,16053,Jerome,-3105,6681,1699,4804
ID,16051,Jefferson,-8592,11381,1303,9895
ID,16049,Idaho County,-4099,7749,1722,5821
ID,16047,Gooding,-2409,5118,1287,3696
ID,16045,Gem,-3354,7490,1957,5311
ID,16043,Fremont,-4097,5802,810,4907
ID,16041,Franklin,-4870,5600,325,5195
ID,16039,Elmore,-2714,8001,2513,5227
ID,16037,Custer,-1214,2352,530,1744
ID,16035,Clearwater,-1509,3696,1032,2541
ID,16033,Clark,-169,328,66,235
ID,16031,Cassia,-6057,8387,1093,7150
ID,16029,Caribou,-2223,3050,385,2608
ID,16027,Canyon,-24503,66090,19866,44369
ID,16025,Camas,-243,578,159,402
ID,16023,Butte,-743,1286,258,1001
ID,16021,Boundary,-1913,4544,1225,3138
ID,16019,Bonneville,-22407,43302,9929,32336
ID,16017,Bonner,-4867,18536,6500,11367
ID,16015,Boise,-1331,3345,953,2284
ID,16013,Blaine,2053,10194,5992,3939
ID,16011,Bingham,-9618,17603,3822,13440
ID,16009,Benewah,-1432,3884,1164,2596
ID,16007,Bear Lake,-2187,2822,302,2489
ID,16005,Bannock,-7796,35260,13214,21010
ID,16003,Adams,-836,2060,577,1413
ID,16001,Ada,-20428,180361,77043,97471
HI,15009,Maui,24402,48547,35979,11577
HI,15007,Kauai,12517,25369,18638,6121
HI,15003,Honolulu,114548,292925,201803,87255
HI,15001,Hawaii,32129,62653,46670,14541
GA,13321,Worth,-3378,8410,2486,5864
GA,13319,Wilkinson,-65,4448,2180,2245
GA,13317,Wilkes,-548,4746,2080,2628
GA,13315,Wilcox,-991,3124,1059,2050
GA,13313,Whitfield,-12097,26828,7193,19290
GA,13311,White,-6977,10471,1670,8647
GA,13309,Wheeler,-594,2160,772,1366
GA,13307,Webster,-25,1175,573,598
GA,13305,Wayne,-4959,10258,2594,7553
GA,13303,Washington,672,8796,4705,4033
GA,13301,Warren,535,2522,1525,990
GA,13299,Ware,-4041,11923,3892,7933
GA,13297,Walton,-20879,37570,8139,29018
GA,13295,Walker,-10976,21879,5269,16245
GA,13293,Upson,-3274,11257,3955,7229
GA,13291,Union,-6634,11072,2137,8771
GA,13289,Twiggs,364,4199,2269,1905
GA,13287,Turner,-519,3556,1508,2027
GA,13285,Troup,-4625,25975,10545,15170
GA,13283,Treutlen,-578,2738,1068,1646
GA,13281,Towns,-3569,6159,1265,4834
GA,13279,Toombs,-3779,9333,2740,6519
GA,13277,Tift,-4531,13893,4640,9171
GA,13275,Thomas,-3502,18943,7651,11153
GA,13273,Terrell,710,4398,2544,1834
GA,13271,Telfair,-675,4334,1804,2479
GA,13269,Taylor,-377,3537,1571,1948
GA,13267,Tattnall,-2808,6658,1894,4702
GA,13265,Taliaferro,315,961,636,321
GA,13263,Talbot,1062,3490,2264,1202
GA,13261,Sumter,998,11820,6370,5372
GA,13259,Stewart,567,2055,1307,740
GA,13257,Stephens,-5084,9467,2123,7207
GA,13255,Spalding,-5017,25057,9884,14901
GA,13253,Seminole,-769,3765,1475,2244
GA,13251,Screven,-516,6093,2769,3285
GA,13249,Schley,-838,1748,448,1286
GA,13247,Rockdale,6207,37879,21878,15671
GA,13245,Richmond,26640,78865,52461,25821
GA,13243,Randolph,500,3015,1749,1249
GA,13241,Rabun,-4195,7438,1558,5753
GA,13239,Quitman,102,1128,612,510
GA,13237,Putnam,-3293,9205,2917,6210
GA,13235,Pulaski,-1225,3681,1219,2444
GA,13233,Polk,-6190,13580,3608,9798
GA,13231,Pike,-5305,8099,1355,6660
GA,13229,Pierce,-4542,6845,1124,5666
GA,13227,Pickens,-8572,12673,1975,10547
GA,13225,Peach,861,11499,6141,5280
GA,13223,Paulding,-24992,57254,15779,40771
GA,13221,Oglethorpe,-2337,6258,1913,4250
GA,13219,Oconee,-8082,16643,4140,12222
GA,13217,Newton,865,43216,21844,20979
GA,13215,Muscogee,14989,70410,42458,27469
GA,13213,Murray,-5897,11209,2542,8439
GA,13211,Morgan,-3427,9016,2751,6178
GA,13209,Montgomery,-1527,3831,1135,2662
GA,13207,Monroe,-4573,12259,3779,8352
GA,13205,Mitchell,-72,8273,4081,4153
GA,13201,Miller,-1056,2770,848,1904
GA,13199,Meriwether,-527,9259,4328,4855
GA,13197,Marion,-320,3167,1411,1731
GA,13195,Madison,-5955,11079,2486,8441
GA,13193,Macon,1666,4781,3211,1545
GA,13191,McIntosh,-545,6333,2860,3405
GA,13189,McDuffie,-1434,9585,4041,5475
GA,13187,Lumpkin,-6584,10878,2049,8633
GA,13185,Lowndes,-4058,38610,17118,21176
GA,13183,Long,-866,3786,1434,2300
GA,13181,Lincoln,-1220,4425,1586,2806
GA,13179,Liberty,4869,16132,10427,5558
GA,13177,Lee,-7123,13607,3187,10310
GA,13175,Laurens,-4439,19591,7508,11947
GA,13173,Lanier,-704,2958,1108,1812
GA,13171,Lamar,-2294,7589,2602,4896
GA,13169,Jones,-3468,12099,4272,7740
GA,13167,Johnson,-1135,3772,1305,2440
GA,13165,Jenkins,-397,3386,1487,1884
GA,13163,Jefferson,1246,7268,4238,2992
GA,13161,Jeff Davis,-2723,5330,1271,3994
GA,13159,Jasper,-2282,6010,1839,4121
GA,13157,Jackson,-14886,23670,4236,19122
GA,13155,Irwin,-1385,3683,1134,2519
GA,13153,Houston,-11988,57912,22643,34631
GA,13151,Henry,-2925,90469,43374,46299
GA,13149,Heard,-2208,4162,947,3155
GA,13147,Hart,-3647,9501,2869,6516
GA,13145,Harris,-7052,15479,4141,11193
GA,13143,Haralson,-6652,10362,1787,8439
GA,13141,Hancock,2537,4076,3301,764
GA,13139,Hall,-33429,59241,12489,45918
GA,13137,Habersham,-9851,14600,2297,12148
GA,13135,Gwinnett,-27684,295560,131879,159563
GA,13133,Greene,-1872,8313,3195,5067
GA,13131,Grady,-2503,9391,3419,5922
GA,13129,Gordon,-9738,16857,3436,13174
GA,13127,Glynn,-8931,33054,11922,20853
GA,13125,Glascock,-959,1333,176,1135
GA,13123,Gilmer,-6965,11008,1955,8920
GA,13121,Fulton,114642,386845,248479,133837
GA,13119,Franklin,-4613,7757,1499,6112
GA,13117,Forsyth,-51309,81598,14544,65853
GA,13115,Floyd,-13041,32685,9595,22636
GA,13113,Fayette,-18343,58473,19703,38046
GA,13111,Fannin,-5826,10007,2027,7853
GA,13109,Evans,-1001,3560,1266,2267
GA,13107,Emanuel,-2167,8060,2919,5086
GA,13105,Elbert,-1678,8139,3179,4857
GA,13103,Effingham,-10650,20779,4941,15591
GA,13101,Echols,-744,1102,173,917
GA,13099,Early,206,5349,2762,2556
GA,13097,Douglas,2184,55201,28410,26226
GA,13095,Dougherty,14768,37822,26209,11441
GA,13093,Dooly,295,4289,2278,1983
GA,13091,Dodge,-2774,7731,2440,5214
GA,13089,DeKalb,173396,305299,237704,64308
GA,13087,Decatur,-1236,10465,4580,5816
GA,13085,Dawson,-7602,10234,1241,8843
GA,13083,Dade,-3054,5997,1404,4458
GA,13081,Crisp,-1019,7386,3160,4179
GA,13079,Crawford,-1667,5123,1699,3366
GA,13077,Coweta,-24477,55512,15156,39633
GA,13075,Cook,-1892,6027,2042,3934
GA,13073,Columbia,-25304,58842,16420,41724
GA,13071,Colquitt,-5269,13319,3971,9240
GA,13069,Coffee,-4194,14434,5048,9242
GA,13067,Cobb,-38938,308989,132526,171464
GA,13065,Clinch,-746,2472,852,1598
GA,13063,Clayton,67281,96020,81439,14158
GA,13061,Clay,325,1402,862,537
GA,13059,Clarke,11582,40138,25386,13804
GA,13057,Cherokee,-56660,98041,19813,76473
GA,13055,Chattooga,-3214,7791,2220,5434
GA,13053,Chattahoochee,-6,1483,726,732
GA,13051,Chatham,12994,108267,60077,47083
GA,13049,Charlton,-1330,3763,1197,2527
GA,13047,Catoosa,-12491,23639,5357,17848
GA,13045,Carroll,-15614,41445,12635,28249
GA,13043,Candler,-1189,3526,1155,2344
GA,13039,Camden,-4960,17938,6358,11318
GA,13037,Calhoun,414,2187,1297,883
GA,13035,Butts,-3340,9372,2966,6306
GA,13033,Burke,1105,9773,5403,4298
GA,13031,Bulloch,-4587,24032,9572,14159
GA,13029,Bryan,-5842,13403,3695,9537
GA,13027,Brooks,-421,6671,3101,3522
GA,13025,Brantley,-4024,6001,939,4963
GA,13023,Bleckley,-2320,4903,1266,3586
GA,13021,Bibb,12932,64625,38538,25606
GA,13019,Berrien,-3569,6187,1268,4837
GA,13017,Ben Hill,-887,5947,2508,3395
GA,13015,Bartow,-18464,35738,8383,26847
GA,13013,Barrow,-12700,25171,6019,18719
GA,13011,Banks,-4574,6191,779,5353
GA,13009,Baldwin,884,16214,8469,7585
GA,13007,Baker,6,1584,790,784
GA,13005,Bacon,-2301,3929,791,3092
GA,13003,Atkinson,-1008,2902,930,1938
GA,13001,Appling,-3475,7079,1756,5231
FL,12133,Washington,-5217,10998,2820,8037
FL,12131,Walton,-14818,28480,6665,21483
FL,12129,Wakulla,-4115,14656,5173,9288
FL,12127,Volusia,-2757,234483,114716,117473
FL,12125,Union,-2641,5393,1339,3980
FL,12123,Taylor,-3488,9117,2761,6249
FL,12121,Suwannee,-7923,17627,4749,12672
FL,12119,Sumter,-21125,60471,19519,40644
FL,12117,Seminole,-13504,208605,96435,109939
FL,12115,Sarasota,-15400,207434,95089,110489
FL,12113,Santa Rosa,-40412,76816,17757,58169
FL,12111,St. Lucie,9667,123026,65869,56202
FL,12109,St. Johns,-43335,114733,35155,78490
FL,12107,Putnam,-7660,31323,11666,19326
FL,12105,Polk,-16956,248658,114610,131566
FL,12103,Pinellas,25774,457484,238966,213192
FL,12101,Pasco,-14187,213358,98148,112335
FL,12099,Palm Beach,102161,600341,349418,247257
FL,12097,Osceola,26620,108647,67201,40581
FL,12095,Orange,85170,467385,274227,189057
FL,12093,Okeechobee,-2469,12321,4856,7325
FL,12091,Okaloosa,-46753,94739,23390,70143
FL,12089,Nassau,-19677,40523,10249,29926
FL,12087,Monroe,158,39045,19392,19234
FL,12086,Miami-Dade,208174,877245,540776,332602
FL,12085,Martin,-18083,78860,30097,48180
FL,12083,Marion,-26213,161368,66823,93036
FL,12081,Manatee,-19140,153451,66476,85616
FL,12079,Madison,-300,8712,4174,4474
FL,12077,Liberty,-1359,3284,942,2301
FL,12075,Levy,-5934,18396,6118,12052
FL,12073,Leon,35057,148335,90863,55806
FL,12071,Lee,-44032,266034,110080,154112
FL,12069,Lake,-25847,150796,61790,87637
FL,12067,Lafayette,-1981,3399,687,2668
FL,12065,Jefferson,137,7808,3945,3808
FL,12063,Jackson,-6075,20940,7342,13417
FL,12061,Indian River,-15958,71445,27483,43441
FL,12059,Holmes,-5655,8274,1264,6919
FL,12057,Hillsborough,36254,541503,286158,249904
FL,12055,Highlands,-9765,42440,16147,25912
FL,12053,Hernando,-7115,83593,37791,44906
FL,12051,Hendry,-604,10185,4751,5355
FL,12049,Hardee,-2233,7222,2461,4694
FL,12047,Hamilton,-911,5404,2226,3137
FL,12045,Gulf,-2982,7107,2013,4995
FL,12043,Glades,-741,3989,1603,2344
FL,12041,Gilchrist,-4032,7908,1885,5917
FL,12039,Gadsden,9140,22495,15768,6628
FL,12037,Franklin,-1725,5474,1845,3570
FL,12035,Flagler,-3762,50589,23204,26966
FL,12033,Escambia,-30517,148430,58154,88671
FL,12031,Duval,-14896,411702,196657,211553
FL,12029,Dixie,-3254,6941,1798,5052
FL,12027,DeSoto,-1413,9863,4174,5587
FL,12023,Columbia,-9967,27163,8462,18429
FL,12021,Collier,-44830,149080,51678,96508
FL,12019,Clay,-44251,96549,25745,69996
FL,12017,Citrus,-16204,73923,28453,44657
FL,12015,Charlotte,-12092,84664,35896,47988
FL,12013,Calhoun,-2702,6152,1664,4366
FL,12011,Broward,263698,755166,507430,243732
FL,12009,Brevard,-36298,285504,122972,159270
FL,12007,Bradford,-4892,11631,3324,8216
FL,12005,Bay,-34826,79834,22037,56863
FL,12003,Baker,-6664,11366,2310,8974
FL,12001,Alachua,20869,120318,69634,48765
DC,11001,District of Columbia,204995,243348,222332,17337
DE,10005,Sussex,-12145,93215,39971,52116
DE,10003,New Castle,85825,251960,167051,81226
DE,10001,Kent,3391,68669,35525,32134
CT,09015,Ashford,528,2173,1331,803
CT,09015,Brooklyn,173,3381,1743,1570
CT,09015,Canterbury,-97,2543,1197,1294
CT,09015,Chaplin,118,1074,584,466
CT,09015,Eastford,-1,1007,464,465
CT,09015,Hampton,188,1029,601,413
CT,09015,Killingly,602,6026,3255,2653
CT,09015,Plainfield,579,5450,2957,2378
CT,09015,Pomfret,91,2149,1103,1012
CT,09015,Putnam,332,3421,1839,1507
CT,09015,Scotland,-7,835,408,415
CT,09015,Sterling,-56,1399,655,711
CT,09015,Thompson,-16,4050,1977,1993
CT,09015,Windham,3874,7875,5818,1944
CT,09015,Woodstock,-113,4222,2021,2134
CT,09013,Andover,180,1647,904,724
CT,09013,Bolton,-1,2911,1433,1434
CT,09013,Columbia,398,3074,1714,1316
CT,09013,Coventry,917,6285,3538,2621
CT,09013,Ellington,-296,7606,3598,3894
CT,09013,Hebron,135,5077,2606,2471
CT,09013,Mansfield,4748,9363,6941,2193
CT,09013,Somers,-782,4946,2055,2837
CT,09013,Stafford,527,5624,3018,2491
CT,09013,Tolland,295,8086,4135,3840
CT,09013,Union,7,516,257,250
CT,09013,Vernon,2467,12815,7546,5079
CT,09013,Willington,297,2830,1538,1241
CT,09011,Bozrah,42,1288,648,606
CT,09011,Colchester,546,7847,4125,3579
CT,09011,East Lyme,1358,8346,4808,3450
CT,09011,Franklin,3,1055,519,516
CT,09011,Griswold,415,4846,2581,2166
CT,09011,Groton,3017,13964,8384,5367
CT,09011,Lebanon,193,3619,1878,1685
CT,09011,Ledyard,355,6900,3564,3209
CT,09011,Lisbon,235,2050,1125,890
CT,09011,Lyme,263,1473,856,593
CT,09011,Montville,899,7230,4014,3115
CT,09011,New London,5056,8499,6710,1654
CT,09011,North Stonington,104,2723,1383,1279
CT,09011,Norwich,4398,12924,8542,4144
CT,09011,Old Lyme,603,4561,2561,1958
CT,09011,Preston,-21,2393,1165,1186
CT,09011,Salem,102,2138,1098,996
CT,09011,Sprague,69,1399,724,655
CT,09011,Stonington,1758,9649,5642,3884
CT,09011,Voluntown,10,1238,610,600
CT,09011,Waterford,1390,9901,5573,4183
CT,09009,Ansonia,1677,6967,4273,2596
CT,09009,Beacon Falls,-298,2959,1300,1598
CT,09009,Bethany,79,3190,1615,1536
CT,09009,Branford,2484,14262,8301,5817
CT,09009,Cheshire,84,14812,7355,7271
CT,09009,Derby,565,4685,2597,2032
CT,09009,East Haven,1883,11302,6533,4650
CT,09009,Guilford,2241,12693,7411,5170
CT,09009,Hamden,11699,26900,19181,7482
CT,09009,Madison,100,10533,5293,5193
CT,09009,Meriden,8006,22006,14886,6880
CT,09009,Middlebury,-1190,4583,1675,2865
CT,09009,Milford,2207,25476,13668,11461
CT,09009,Naugatuck,116,11918,5923,5807
CT,09009,New Haven,35435,44643,39865,4430
CT,09009,North Branford,85,6738,3375,3290
CT,09009,North Haven,386,12502,6376,5990
CT,09009,Orange,-599,7895,3607,4206
CT,09009,Oxford,-1306,6598,2599,3905
CT,09009,Prospect,-1396,5149,1839,3235
CT,09009,Seymour,-183,7186,3447,3630
CT,09009,Southbury,-1202,10159,4424,5626
CT,09009,Wallingford,2300,21083,11559,9259
CT,09009,Waterbury,21452,43804,32495,11043
CT,09009,West Haven,8497,20278,14286,5789
CT,09009,Wolcott,-1938,8298,3139,5077
CT,09009,Woodbridge,914,5164,3018,2104
CT,09007,Chester,673,2109,1380,707
CT,09007,Clinton,681,6592,3607,2926
CT,09007,Cromwell,870,7348,4063,3193
CT,09007,Deep River,547,2433,1479,932
CT,09007,Durham,28,4026,2013,1985
CT,09007,East Haddam,362,4662,2471,2109
CT,09007,East Hampton,371,6738,3509,3138
CT,09007,Essex,529,3975,2230,1701
CT,09007,Haddam,116,4646,2346,2230
CT,09007,Killingworth,81,3816,1921,1840
CT,09007,Middlefield,166,2539,1334,1168
CT,09007,Middletown,7725,20219,13830,6105
CT,09007,Old Saybrook,348,5916,3101,2753
CT,09007,Portland,523,4875,2664,2141
CT,09007,Westbrook,298,3553,1903,1605
CT,09005,Barkhamsted,0,2105,1033,1033
CT,09005,Bethlehem,-378,2182,894,1272
CT,09005,Bridgewater,-112,1186,529,641
CT,09005,Canaan,174,606,384,210
CT,09005,Colebrook,-82,856,380,462
CT,09005,Cornwall,379,883,629,250
CT,09005,Goshen,-268,1785,749,1017
CT,09005,Harwinton,-664,3244,1260,1924
CT,09005,Kent,474,1706,1080,606
CT,09005,Litchfield,-252,4632,2151,2403
CT,09005,Morris,-205,1309,542,747
CT,09005,New Hartford,-297,3881,1759,2056
CT,09005,New Milford,310,13160,6640,6330
CT,09005,Norfolk,172,949,556,384
CT,09005,North Canaan,154,1277,706,552
CT,09005,Plymouth,-160,5352,2553,2713
CT,09005,Roxbury,52,1477,758,706
CT,09005,Salisbury,893,2243,1552,659
CT,09005,Sharon,383,1440,902,519
CT,09005,Thomaston,-588,3763,1556,2144
CT,09005,Torrington,-477,14419,6843,7320
CT,09005,Warren,-3,827,404,407
CT,09005,Washington,413,2082,1237,824
CT,09005,Watertown,-2490,10806,4091,6581
CT,09005,Winchester,-188,4680,2201,2389
CT,09005,Woodbury,-624,5554,2434,3058
CT,09003,Avon,768,11947,6305,5537
CT,09003,Berlin,138,10984,5499,5361
CT,09003,Bloomfield,7992,11891,9917,1925
CT,09003,Bristol,2735,24088,13283,10548
CT,09003,Burlington,-326,5098,2357,2683
CT,09003,Canton,225,5791,2967,2742
CT,09003,East Granby,-59,2878,1389,1448
CT,09003,East Hartford,8728,17417,13000,4272
CT,09003,East Windsor,822,5387,3072,2250
CT,09003,Enfield,2442,18143,10145,7703
CT,09003,Farmington,402,13780,7012,6610
CT,09003,Glastonbury,1326,19166,10135,8809
CT,09003,Granby,-142,6378,3079,3221
CT,09003,Hartford,29597,34037,31735,2138
CT,09003,Hartland,-364,1208,414,778
CT,09003,Manchester,7604,23869,15565,7961
CT,09003,Marlborough,123,3509,1791,1668
CT,09003,New Britain,11269,21208,16051,4782
CT,09003,Newington,3040,14735,8792,5752
CT,09003,Plainville,1225,7967,4545,3320
CT,09003,Rocky Hill,1144,9308,5173,4029
CT,09003,Simsbury,143,13742,6853,6710
CT,09003,Southington,275,21462,10727,10452
CT,09003,South Windsor,1934,13659,7708,5774
CT,09003,Suffield,-531,7271,3332,3863
CT,09003,West Hartford,10542,31968,21080,10538
CT,09003,Wethersfield,1738,13936,7753,6015
CT,09003,Windsor,7156,15938,11461,4305
CT,09003,Windsor Locks,720,5720,3174,2454
CT,09001,Bethel,332,9333,4777,4445
CT,09001,Bridgeport,26967,37476,32135,5168
CT,09001,Brookfield,-1025,8965,3916,4941
CT,09001,Danbury,4700,26161,15290,10590
CT,09001,Darien,-3038,9468,3182,6220
CT,09001,Easton,-539,4266,1841,2380
CT,09001,Fairfield,930,29933,15282,14352
CT,09001,Greenwich,-3231,25714,11137,14368
CT,09001,Monroe,-1311,10335,4446,5757
CT,09001,New Canaan,-3162,10862,3804,6966
CT,09001,New Fairfield,-965,7699,3323,4288
CT,09001,Newtown,-769,14575,6822,7591
CT,09001,Norwalk,9596,35499,22369,12773
CT,09001,Redding,284,5351,2787,2503
CT,09001,Ridgefield,-899,13955,6461,7360
CT,09001,Shelton,-1965,18904,8362,10327
CT,09001,Sherman,-29,2096,1020,1049
CT,09001,Stamford,12150,47529,29623,17473
CT,09001,Stratford,4159,23034,13483,9324
CT,09001,Trumbull,-1283,18869,8703,9986
CT,09001,Weston,397,5425,2911,2514
CT,09001,Westport,2055,15047,8494,6439
CT,09001,Wilton,-835,10115,4589,5424
CO,08125,Yuma,-2483,4481,950,3433
CO,08123,Weld,-14932,112695,47418,62350
CO,08121,Washington,-1598,2567,461,2059
CO,08119,Teller,-4015,12144,3894,7909
CO,08117,Summit,3674,15038,9169,5495
CO,08115,Sedgwick,-462,1337,419,881
CO,08113,San Miguel,1817,4215,2961,1144
CO,08111,San Juan,54,506,266,212
CO,08109,Saguache,825,2796,1762,937
CO,08107,Routt,2028,13038,7389,5361
CO,08105,Rio Grande,-464,5453,2428,2892
CO,08103,Rio Blanco,-2116,3311,561,2677
CO,08101,Pueblo,9601,73306,40624,31023
CO,08099,Prowers,-1702,4809,1498,3200
CO,08097,Pitkin,3707,9779,6648,2941
CO,08095,Phillips,-1049,2265,588,1637
CO,08093,Park,-1364,9054,3721,5085
CO,08091,Ouray,170,3183,1640,1470
CO,08089,Otero,-749,8039,3566,4315
CO,08087,Morgan,-2700,10478,3761,6461
CO,08085,Montrose,-6937,19054,5852,12789
CO,08083,Montezuma,-2886,12232,4486,7372
CO,08081,Moffat,-3325,6042,1291,4616
CO,08079,Mineral,-53,650,291,344
CO,08077,Mesa,-22639,69033,22448,45087
CO,08075,Logan,-3449,9030,2675,6124
CO,08073,Lincoln,-1126,2248,537,1663
CO,08071,Las Animas,177,6532,3282,3105
CO,08069,Larimer,8500,161823,83103,74603
CO,08067,La Plata,2509,28475,15063,12554
CO,08065,Lake,720,2993,1807,1087
CO,08063,Kit Carson,-1875,3525,789,2664
CO,08061,Kiowa,-559,821,118,677
CO,08059,Jefferson,13109,300151,153069,139960
CO,08057,Jackson,-384,848,216,600
CO,08055,Huerfano,282,3623,1897,1615
CO,08053,Hinsdale,-124,598,228,352
CO,08051,Gunnison,1457,7912,4563,3106
CO,08049,Grand,-574,7961,3575,4149
CO,08047,Gilpin,534,3271,1854,1320
CO,08045,Garfield,-1170,23695,10989,12159
CO,08043,Fremont,-6443,20258,6644,13087
CO,08041,El Paso,-58830,275604,104989,163819
CO,08039,Elbert,-6606,13993,3542,10148
CO,08037,Eagle,3281,22374,12598,9317
CO,08035,Douglas,-39837,150160,54093,93930
CO,08033,Dolores,-509,1218,329,838
CO,08031,Denver,140004,285564,209759,69755
CO,08029,Delta,-6220,15681,4542,10762
CO,08027,Custer,-914,2697,862,1776
CO,08025,Crowley,-389,1502,535,924
CO,08023,Costilla,877,1804,1317,440
CO,08021,Conejos,386,4027,2180,1794
CO,08019,Clear Creek,660,5610,3041,2381
CO,08017,Cheyenne,-696,1045,162,858
CO,08015,Chaffee,18,10217,4967,4949
CO,08014,Broomfield,1888,32191,16653,14765
CO,08013,Boulder,71959,173207,120485,48526
CO,08011,Bent,-275,1881,778,1053
CO,08009,Baca,-1092,2096,462,1554
CO,08007,Archuleta,-1194,6646,2637,3831
CO,08005,Arapahoe,21201,254746,135433,114232
CO,08003,Alamosa,1089,6671,3782,2693
CO,08001,Adams,24312,161495,90843,66531
CA,06115,Yuba,-2929,15009,5817,8746
CA,06113,Yolo,19776,59613,38856,19080
CA,06111,Ventura,14200,267907,138119,123919
CA,06109,Tuolumne,-3782,23730,9628,13410
CA,06107,Tulare,-12995,72832,29191,42186
CA,06105,Trinity,-55,5030,2367,2422
CA,06103,Tehama,-4759,17356,6032,10791
CA,06101,Sutter,-4572,20988,8004,12576
CA,06099,Stanislaus,1060,143620,70609,69549
CA,06097,Sonoma,78838,175738,124504,45666
CA,06095,Solano,38861,138565,87225,48364
CA,06093,Siskiyou,-2734,17505,7110,9844
CA,06091,Sierra,-404,1779,652,1056
CA,06089,Shasta,-16377,54121,18184,34561
CA,06087,Santa Cruz,43974,81294,61106,17132
CA,06085,Santa Clara,206892,491687,343239,136347
CA,06083,Santa Barbara,25183,147249,84279,59096
CA,06081,San Mateo,94792,211814,151036,56244
CA,06079,San Luis Obispo,1155,117597,57655,56500
CA,06077,San Joaquin,13263,149587,80005,66742
CA,06075,San Francisco,225203,321023,267857,42654
CA,06073,San Diego,47340,928256,478386,431046
CA,06071,San Bernardino,28735,531692,274203,245468
CA,06069,San Benito,2565,14972,8617,6052
CA,06067,Sacramento,63375,388090,221063,157688
CA,06065,Riverside,-2473,589721,287754,290227
CA,06063,Plumas,-1570,9128,3670,5240
CA,06061,Placer,-25334,126325,49126,74460
CA,06059,Orange,-84515,1021315,457077,541592
CA,06057,Nevada,-1435,30864,14261,15696
CA,06055,Napa,8317,32332,19964,11647
CA,06053,Monterey,26625,78522,51712,25087
CA,06051,Mono,372,4917,2574,2202
CA,06049,Modoc,-1666,3986,1113,2779
CA,06047,Merced,2725,50538,26128,23403
CA,06045,Mendocino,6740,17928,11869,5129
CA,06043,Mariposa,-1354,7805,3080,4434
CA,06041,Marin,50103,99286,73450,23347
CA,06039,Madera,-6292,32372,12698,18990
CA,06037,Los Angeles,972564,2427869,1672164,699600
CA,06035,Lassen,-4217,10603,3044,7261
CA,06033,Lake,2685,16274,9159,6474
CA,06031,Kings,-4902,30139,12282,17184
CA,06029,Kern,-35150,168116,64690,99840
CA,06027,Inyo,-766,6501,2775,3541
CA,06025,Imperial,7919,27453,17464,9545
CA,06023,Humboldt,12104,46269,27757,15653
CA,06021,Glenn,-2332,9142,3276,5608
CA,06019,Fresno,-5281,180244,85862,91143
CA,06017,El Dorado,-15628,85923,34033,49661
CA,06015,Del Norte,-860,7940,3396,4256
CA,06013,Contra Costa,118279,351257,230826,112547
CA,06011,Colusa,-1273,5865,2248,3521
CA,06009,Calaveras,-3133,18469,7404,10537
CA,06007,Butte,-2745,70163,32567,35312
CA,06005,Amador,-2902,15303,6001,8903
CA,06003,Alpine,153,647,389,236
CA,06001,Alameda,333761,558386,438091,104330
AR,05149,Yell,-2321,5971,1720,4041
AR,05147,Woodruff,113,2685,1340,1227
AR,05145,White,-14240,26508,5765,20005
AR,05143,Washington,-11434,70231,28136,39570
AR,05141,Van Buren,-2536,6421,1826,4362
AR,05139,Union,-4514,17160,6182,10696
AR,05137,Stone,-2417,5351,1356,3773
AR,05135,Sharp,-2828,7282,2092,4920
AR,05133,Sevier,-2093,4328,1042,3135
AR,05131,Sebastian,-16075,43340,13083,29158
AR,05129,Searcy,-1885,3694,814,2699
AR,05127,Scott,-1735,3637,895,2630
AR,05125,Saline,-20094,47059,12868,32962
AR,05123,Saint Francis,1365,8021,4652,3287
AR,05121,Randolph,-1659,5948,2040,3699
AR,05119,Pulaski,18199,159055,87055,68856
AR,05117,Prairie,-1272,3134,877,2149
AR,05115,Pope,-9625,20390,5108,14733
AR,05113,Polk,-4394,7721,1556,5950
AR,05111,Poinsett,-2580,7550,2387,4967
AR,05109,Pike,-1997,3787,850,2847
AR,05107,Phillips,2588,7900,5179,2591
AR,05105,Perry,-1393,3937,1187,2580
AR,05103,Ouachita,-890,10303,4626,5516
AR,05101,Newton,-1515,3661,993,2508
AR,05099,Nevada,-682,3384,1314,1996
AR,05097,Montgomery,-1448,3403,920,2368
AR,05095,Monroe,-2,3230,1583,1585
AR,05093,Mississippi,-154,13349,6445,6599
AR,05091,Miller,-6104,15329,4518,10622
AR,05089,Marion,-2747,7029,2024,4771
AR,05087,Madison,-2163,6567,2099,4262
AR,05085,Lonoke,-12251,24083,5612,17863
AR,05083,Logan,-3069,7330,2009,5078
AR,05081,Little River,-1833,5051,1552,3385
AR,05079,Lincoln,-775,3725,1424,2199
AR,05077,Lee,827,3424,2107,1280
AR,05075,Lawrence,-1749,5537,1786,3535
AR,05073,Lafayette,-539,2928,1173,1712
AR,05071,Johnson,-2260,8064,2785,5045
AR,05069,Jefferson,7941,27364,17456,9515
AR,05067,Jackson,-972,5338,2093,3065
AR,05065,Izard,-2008,5313,1563,3571
AR,05063,Independence,-5445,12390,3279,8724
AR,05061,Howard,-1402,4419,1460,2862
AR,05059,Hot Spring,-3263,11239,3824,7087
AR,05057,Hempstead,-1818,6919,2466,4284
AR,05055,Greene,-5068,13754,3998,9066
AR,05053,Grant,-3362,6478,1467,4829
AR,05051,Garland,-11714,39241,13317,25031
AR,05049,Fulton,-1497,4522,1452,2949
AR,05047,Franklin,-2906,6539,1725,4631
AR,05045,Faulkner,-13094,41322,13559,26653
AR,05043,Drew,-1256,6626,2627,3883
AR,05041,Desha,546,4240,2353,1807
AR,05039,Dallas,-327,3083,1337,1664
AR,05037,Cross,-1989,6680,2279,4268
AR,05035,Crittenden,2900,15513,9092,6192
AR,05033,Crawford,-10253,20562,4872,15125
AR,05031,Craighead,-9693,31207,10351,20044
AR,05029,Conway,-1508,7724,3003,4511
AR,05027,Columbia,-2233,9455,3557,5790
AR,05025,Cleveland,-1468,3266,845,2313
AR,05023,Cleburne,-6073,11643,2618,8691
AR,05021,Clay,-1487,5110,1738,3225
AR,05019,Clark,-535,8406,3808,4343
AR,05017,Chicot,979,4361,2649,1670
AR,05015,Carroll,-2430,10172,3691,6121
AR,05013,Calhoun,-798,2174,660,1458
AR,05011,Bradley,-671,3634,1447,2118
AR,05009,Boone,-7381,15363,3762,11143
AR,05007,Benton,-31333,77525,22144,53477
AR,05005,Baxter,-8516,19339,5172,13688
AR,05003,Ashley,-2011,7915,2855,4866
AR,05001,Arkansas,-1438,6488,2454,3892
AZ,04027,Yuma,-5475,33935,14025,19500
AZ,04025,Yavapai,-29761,96790,32624,62385
AZ,04023,Santa Cruz,5251,13894,9486,4235
AZ,04021,Pinal,-17519,102139,41428,58947
AZ,04019,Pima,20543,351817,183470,162927
AZ,04017,Navajo,-2998,35775,16157,19155
AZ,04015,Mohave,-28118,65949,18324,46442
AZ,04013,Maricopa,-142827,1187008,512008,654835
AZ,04012,La Paz,-1586,4922,1619,3205
AZ,04011,Greenlee,-280,2972,1310,1590
AZ,04009,Graham,-4468,11854,3608,8076
AZ,04007,Gila,-4875,18477,6650,11525
AZ,04005,Coconino,6948,46746,26316,19368
AZ,04003,Cochise,-10519,43776,16223,26742
AZ,04001,Apache,8635,25465,16833,8198
AK,02000,Alaska,-29538,220596,91696,121234
AL,01133,Winston,-7024,9712,1286,8310
AL,01131,Wilcox,3191,6547,4867,1676
AL,01129,Washington,-2778,8761,2971,5749
AL,01127,Walker,-15082,28497,6551,21633
AL,01125,Tuscaloosa,-13700,78495,32003,45703
AL,01123,Tallapoosa,-6051,18668,6252,12303
AL,01121,Talladega,-5339,33317,13878,19217
AL,01119,Sumter,3835,7025,5420,1585
AL,01117,Shelby,-51299,92204,19944,71243
AL,01115,St. Clair,-23211,35105,5790,29001
AL,01113,Russell,2219,18871,10495,8276
AL,01111,Randolph,-4143,10391,3076,7219
AL,01109,Pike,-1930,14057,6009,7939
AL,01107,Pickens,-671,9599,4448,5119
AL,01105,Perry,3032,6065,4536,1504
AL,01103,Morgan,-21908,49198,13401,35309
AL,01101,Montgomery,24710,101781,62993,38283
AL,01099,Monroe,-833,10680,4897,5730
AL,01097,Mobile,-16149,174189,78417,94566
AL,01095,Marshall,-19514,32455,6271,25785
AL,01093,Marion,-7447,12104,2249,9696
AL,01091,Marengo,833,11509,6154,5321
AL,01089,Madison,-28877,154632,61802,90679
AL,01087,Macon,7723,10385,9045,1322
AL,01085,Lowndes,3993,7519,5747,1754
AL,01083,Limestone,-15454,35406,9809,25263
AL,01081,Lee,-10788,54115,21274,32062
AL,01079,Lawrence,-3800,14079,5055,8855
AL,01077,Lauderdale,-11398,36908,12504,23902
AL,01075,Lamar,-3810,7159,1643,5453
AL,01073,Jefferson,18245,303424,159658,141413
AL,01071,Jackson,-8605,20555,5817,14422
AL,01069,Houston,-16866,41843,12348,29214
AL,01067,Henry,-2559,8700,3046,5605
AL,01065,Hale,2196,8628,5401,3205
AL,01063,Greene,3715,5328,4514,799
AL,01061,Geneva,-7134,11318,2039,9173
AL,01059,Franklin,-4396,10859,3171,7567
AL,01057,Fayette,-4231,7912,1803,6034
AL,01055,Etowah,-16310,42490,12792,29102
AL,01053,Escambia,-3787,14832,5476,9263
AL,01051,Elmore,-17283,35440,8940,26223
AL,01049,DeKalb,-13081,23842,5235,18316
AL,01047,Dallas,8315,20936,14599,6284
AL,01045,Dale,-7822,18551,5283,13105
AL,01043,Cullman,-23075,33178,4855,27930
AL,01041,Crenshaw,-2278,6411,2048,4326
AL,01039,Covington,-8993,15415,3155,12148
AL,01037,Coosa,-840,5243,2188,3028
AL,01035,Conecuh,117,7013,3551,3434
AL,01033,Colbert,-4771,23374,9160,13931
AL,01031,Coffee,-9739,19715,4899,14638
AL,01029,Cleburne,-4298,6302,971,5269
AL,01027,Clay,-3032,6640,1770,4802
AL,01025,Clarke,-1146,13827,6317,7463
AL,01023,Choctaw,-365,7965,3785,4150
AL,01021,Chilton,-10519,17434,3391,13910
AL,01019,Cherokee,-5368,9761,2126,7494
AL,01017,Chambers,-743,14562,6853,7596
AL,01015,Calhoun,-14772,46240,15500,30272
AL,01013,Butler,-714,9483,4367,5081
AL,01011,Bullock,2808,5318,4058,1250
AL,01009,Blount,-17780,23980,2961,20741
AL,01007,Bibb,-3931,8391,2200,6131
AL,01005,Barbour,334,11459,5873,5539
AL,01003,Baldwin,-47443,84988,18329,65772
AL,01001,Autauga,-11012,23909,6354,17366
